Date,State,County,BEVCount,PHEVCount,EVTotal,NonEVTotal
2021-04-30,WA,Thurston,0,0,0,56710
2017-10-31,WA,Adams,3,3,6,12283
2018-07-31,WA,Whatcom,2,0,2,42313
2019-08-31,WA,Grays Harbor,0,0,0,20570
2019-10-31,WA,Cowlitz,0,0,0,29023
2018-06-30,WA,Spokane,340,316,656,303132
2018-03-31,WA,Kittitas,0,0,0,13984
2022-11-30,CA,Solano,2,0,2,146
2018-03-31,WA,Thurston,518,432,950,191158
2021-11-30,WA,Whitman,66,58,124,21959
2019-04-30,WA,Pierce,1692,1486,3178,540913
2018-12-31,WA,Franklin,0,0,0,19057
2022-09-30,WA,Pend Oreille,0,0,0,5638
2017-05-31,WA,Thurston,390,334,724,186064
2018-07-31,WA,Whatcom,637,318,955,147985
2018-09-30,WA,Cowlitz,63,85,148,72024
2017-07-31,WA,Pierce,986,856,1842,524592
2019-01-31,WA,San Juan,0,0,0,5802
2023-06-30,WA,Thurston,60,0,60,53269
2023-02-28,CA,Santa Clara,8,2,10,163
2022-12-31,CA,San Joaquin,1,0,1,75
2022-05-31,WA,Kittitas,248,79,327,29757
2017-10-31,WA,Mason,0,0,0,19470
2020-05-31,WA,Chelan,228,78,306,54111
2022-03-31,WA,Whatcom,4,0,4,43546
2017-03-31,WA,Pacific,6,8,14,15078
2022-10-31,WA,Walla Walla,190,107,297,35711
2022-06-30,CA,San Joaquin,1,1,2,85
2021-06-30,WA,Jefferson,331,184,515,24891
2022-02-28,WA,Pacific,58,65,123,16024
2019-04-30,WA,Clark,0,0,0,80105
2018-06-30,WA,Garfield,0,0,0,950
2019-08-31,WA,Mason,130,127,257,47429
2017-08-31,CA,Tuolumne,0,1,1,14
2017-05-31,WA,Klickitat,22,24,46,14787
2017-08-31,WA,Lincoln,1,5,6,7571
2018-08-31,WA,Garfield,1,1,2,1318
2020-12-31,WA,Lincoln,0,0,0,4673
2017-04-30,WA,Island,108,128,236,59768
2018-06-30,WA,Lewis,0,0,0,25481
2021-06-30,CA,Ventura,1,2,3,255
2019-04-30,WA,Grant,0,0,0,26430
2021-10-31,WA,Kitsap,2042,916,2958,180643
2017-09-30,WA,Kittitas,33,21,54,27988
2019-12-31,WA,Asotin,14,9,23,12679
2022-10-31,WA,Pend Oreille,18,12,30,9012
2017-08-31,WA,Asotin,8,5,13,12444
2021-01-31,WA,Asotin,0,0,0,6690
2019-06-30,CA,Santa Clara,5,2,7,364
2021-01-31,WA,Mason,179,137,316,47690
2021-10-31,WA,Ferry,11,3,14,4446
2022-12-31,WA,Stevens,2,0,2,18846
2018-08-31,WA,Whatcom,653,321,974,148265
2019-10-31,WA,Douglas,63,38,101,28272
2020-08-31,WA,Klickitat,0,0,0,8105
2023-06-30,CA,Santa Barbara,1,0,1,58
2020-01-31,CA,Los Angeles,8,11,19,1058
2017-04-30,WA,Clark,0,0,0,77561
2019-02-28,WA,Grays Harbor,0,0,0,20318
2021-01-31,WA,Whitman,0,0,0,8512
2021-03-31,CA,Sacramento,2,0,2,232
2017-12-31,WA,Wahkiakum,0,2,2,2860
2020-05-31,CA,Contra Costa,3,2,5,318
2019-03-31,WA,Douglas,0,0,0,12157
2022-11-30,WA,Whitman,109,65,174,21989
2017-12-31,WA,Franklin,0,0,0,18492
2022-09-30,WA,Douglas,1,0,1,12781
2017-12-31,WA,San Juan,132,43,175,13853
2019-04-30,WA,Wahkiakum,0,0,0,1733
2020-12-31,WA,Clallam,1,0,1,21831
2017-08-31,WA,Thurston,0,0,0,53429
2021-01-31,WA,Adams,0,0,0,5347
2017-05-31,WA,Skamania,0,0,0,3863
2017-01-31,WA,Garfield,0,0,0,941
2022-08-31,WA,Pierce,34,0,34,140861
2018-09-30,WA,Walla Walla,0,0,0,13492
2020-09-30,WA,Cowlitz,157,120,277,72161
2021-12-31,WA,Benton,0,0,0,43707
2022-04-30,WA,Whitman,0,0,0,8586
2021-03-31,CA,San Francisco,1,1,2,90
2021-07-31,WA,San Juan,443,139,582,14241
2021-05-31,WA,Adams,0,0,0,5374
2020-12-31,WA,Columbia,0,0,0,1543
2017-02-28,WA,Columbia,0,1,1,2337
2021-12-31,WA,Lewis,206,164,370,59615
2021-06-30,WA,Snohomish,5886,2048,7934,540300
2019-01-31,WA,Ferry,3,2,5,4388
2022-03-31,WA,Cowlitz,293,172,465,71084
2019-05-31,WA,Skagit,292,200,492,91700
2018-01-31,WA,Garfield,0,0,0,945
2017-05-31,WA,King,9796,3990,13786,1377129
2021-08-31,CA,San Diego,17,7,24,2518
2023-01-31,WA,Chelan,15,0,15,23105
2022-09-30,WA,Walla Walla,2,0,2,13946
2018-03-31,CA,Los Angeles,5,4,9,1180
2021-09-30,WA,Walla Walla,0,0,0,14076
2018-05-31,WA,Wahkiakum,0,0,0,1674
2020-11-30,WA,Adams,10,6,16,12942
2020-08-31,CA,Alameda,2,0,2,266
2020-07-31,WA,Snohomish,4583,1775,6358,535609
2022-11-30,WA,Grays Harbor,242,161,403,48681
2018-04-30,WA,Lincoln,0,0,0,4532
2021-04-30,WA,Snohomish,1,0,1,126400
2019-08-31,WA,Stevens,22,29,51,31707
2018-05-31,WA,Whitman,0,0,0,8470
2023-06-30,WA,Spokane,40,0,40,100674
2019-01-31,WA,Okanogan,0,0,0,16477
2023-02-28,CA,Santa Cruz,1,0,1,12
2022-12-31,WA,Snohomish,10174,2763,12937,530310
2021-07-31,WA,Okanogan,0,0,0,16751
2021-11-30,CA,Orange,5,2,7,384
2021-05-31,WA,Ferry,9,3,12,4373
2017-12-31,WA,Jefferson,0,0,0,9475
2020-03-31,WA,Douglas,0,0,0,12333
2018-04-30,CA,Santa Clara,6,1,7,380
2020-05-31,WA,Spokane,1,0,1,97688
2021-06-30,WA,Stevens,45,45,90,30479
2017-09-30,WA,Ferry,0,0,0,3538
2019-02-28,WA,Garfield,0,0,0,961
2021-03-31,WA,Clallam,1,0,1,21955
2022-07-31,WA,Pacific,0,0,0,7881
2020-07-31,WA,Pacific,33,33,66,15766
2021-08-31,WA,Island,0,0,0,21590
2021-05-31,WA,Adams,11,9,20,13043
2018-07-31,WA,Skagit,1,0,1,32118
2021-03-31,WA,Skagit,1,0,1,32932
2023-04-30,CA,Kings,2,1,3,264
2023-02-28,CA,Monterey,1,1,2,113
2018-01-31,WA,Walla Walla,0,0,0,13323
2018-06-30,WA,Pierce,1228,1173,2401,532275
2018-10-31,WA,Island,0,0,0,21130
2021-05-31,WA,Lincoln,5,13,18,7733
2023-02-28,CA,Solano,4,0,4,135
2017-02-28,WA,Pacific,5,6,11,14997
2020-08-31,WA,Pacific,0,0,0,7724
2022-12-31,WA,Lewis,1,0,1,26311
2020-11-30,WA,Walla Walla,95,66,161,36066
2021-05-31,WA,Whatcom,1386,596,1982,150988
2021-11-30,WA,Spokane,1262,748,2010,327064
2019-12-31,WA,Jefferson,0,0,0,9647
2021-04-30,WA,Skagit,1,0,1,33024
2018-07-31,WA,Grays Harbor,0,0,0,20227
2021-12-31,WA,Pend Oreille,0,0,0,5703
2018-03-31,WA,Pend Oreille,4,3,7,9455
2018-08-31,WA,Snohomish,2471,1311,3782,523635
2022-12-31,WA,Stevens,90,56,146,30021
2021-08-31,WA,Columbia,0,0,0,1539
2017-11-30,WA,Ferry,1,3,4,4408
2022-06-30,WA,Clallam,3,0,3,21937
2023-03-31,WA,Benton,1041,531,1572,135436
2018-01-31,WA,Klickitat,0,0,0,8000
2020-04-30,CA,Placer,2,0,2,89
2020-11-30,CA,Riverside,4,1,5,598
2021-05-31,CA,San Joaquin,1,0,1,105
2017-11-30,WA,Okanogan,5,17,22,25731
2022-01-31,WA,Douglas,118,56,174,28586
2022-08-31,WA,Thurston,17,0,17,55162
2018-08-31,WA,Jefferson,0,0,0,9623
2018-04-30,WA,Franklin,0,0,0,18597
2017-02-28,WA,Island,100,122,222,59448
2018-09-30,WA,Skagit,222,176,398,90860
2018-07-31,WA,Pacific,0,0,0,7611
2021-10-31,CA,Monterey,0,1,1,142
2020-08-31,WA,King,5,1,6,183316
2022-02-28,WA,Whatcom,1690,685,2375,149351
2023-07-31,CA,San Bernardino,2,1,3,231
2022-12-31,CA,Napa,0,1,1,9
2020-04-30,WA,King,24085,7696,31781,1386024
2019-09-30,WA,Cowlitz,106,106,212,73309
2023-02-28,WA,Skagit,987,377,1364,89175
2017-10-31,WA,Pend Oreille,3,4,7,9370
2017-03-31,WA,Kittitas,17,16,33,27117
2019-12-31,WA,Clallam,196,157,353,50869
2023-07-31,WA,Skagit,1139,417,1556,86446
2019-11-30,WA,Asotin,13,8,21,12655
2021-05-31,WA,Pend Oreille,0,0,0,5748
2022-10-31,WA,Ferry,24,4,28,4384
2021-06-30,WA,Mason,0,0,0,21335
2023-06-30,WA,Lincoln,0,0,0,4817
2022-03-31,WA,Okanogan,77,46,123,26522
2018-02-28,WA,Mason,0,0,0,19725
2018-12-31,WA,Snohomish,1,0,1,121967
2020-04-30,WA,Pend Oreille,0,0,0,5739
2020-05-31,WA,Pacific,0,0,0,7625
2022-07-31,WA,Clark,4229,1806,6035,315632
2018-07-31,WA,Okanogan,0,0,0,16423
2019-01-31,CA,Ventura,0,2,2,314
2020-07-31,CA,Monterey,0,1,1,162
2017-03-31,WA,Lincoln,0,0,0,4469
2018-11-30,WA,Kittitas,61,34,95,29286
2018-04-30,CA,Los Angeles,6,4,10,1172
2020-03-31,WA,Adams,7,7,14,12891
2023-07-31,WA,Grays Harbor,311,192,503,47081
2021-07-31,WA,Benton,0,0,0,43648
2017-08-31,WA,Kitsap,637,336,973,173831
2018-05-31,WA,Skagit,198,163,361,90254
2020-11-30,WA,Pend Oreille,0,0,0,5718
2020-12-31,WA,Benton,0,0,0,43207
2019-01-31,WA,Stevens,0,0,0,18768
2020-06-30,WA,Pacific,33,33,66,15754
2019-05-31,CA,Santa Clara,7,1,8,366
2023-01-31,CA,San Joaquin,1,0,1,74
2020-12-31,WA,Chelan,278,88,366,54504
2022-04-30,WA,Cowlitz,0,1,1,28734
2018-06-30,WA,Clallam,0,0,0,21442
2019-07-31,CA,Riverside,3,2,5,653
2023-07-31,WA,Chelan,31,0,31,22570
2017-08-31,WA,Walla Walla,0,0,0,13188
2018-12-31,WA,Skamania,16,13,29,8731
2017-10-31,CA,Monterey,0,2,2,193
2017-05-31,CA,Alameda,1,1,2,372
2023-06-30,WA,Clark,5813,2318,8131,309808
2019-04-30,WA,Wahkiakum,1,1,2,3014
2020-07-31,WA,Skamania,0,0,0,4032
2020-11-30,CA,Santa Cruz,1,0,1,29
2018-02-28,WA,Grant,31,38,69,62313
2019-01-31,WA,Island,0,0,0,21211
2020-04-30,WA,Pierce,2347,1682,4029,548871
2017-06-30,WA,Ferry,0,0,0,3537
2019-12-31,WA,Grant,0,0,0,27002
2018-02-28,WA,Pacific,15,17,32,15463
2021-10-31,WA,Snohomish,2,0,2,125795
2023-03-31,WA,Okanogan,114,58,172,26014
2018-03-31,WA,Okanogan,0,0,0,16333
2020-02-29,CA,Santa Cruz,1,0,1,36
2021-10-31,WA,Stevens,0,0,0,18891
2021-06-30,WA,Chelan,336,99,435,54745
2022-10-31,CA,Santa Cruz,1,0,1,19
2021-01-31,WA,San Juan,377,113,490,14023
2017-11-30,WA,Pacific,0,0,0,7535
2022-01-31,WA,Whatcom,3,0,3,43614
2019-02-28,WA,Benton,233,245,478,132999
2022-12-31,WA,Pacific,74,80,154,15740
2022-09-30,WA,Skagit,869,349,1218,89712
2020-11-30,WA,Skamania,33,21,54,8305
2021-05-31,WA,Kitsap,0,0,0,54547
2018-08-31,CA,Los Angeles,7,4,11,1136
2017-10-31,WA,Grant,20,33,53,61666
2019-06-30,WA,Franklin,52,70,122,59912
2022-06-30,CA,San Mateo,2,0,2,78
2020-11-30,WA,San Juan,0,0,0,5866
2021-06-30,WA,Snohomish,1,0,1,126272
2017-03-31,WA,Skagit,1,0,1,31426
2023-02-28,WA,Cowlitz,424,193,617,70210
2023-01-31,WA,Clark,5070,2078,7148,314583
2020-05-31,WA,Wahkiakum,6,6,12,2965
2017-11-30,WA,Clallam,0,0,0,21181
2018-01-31,WA,Spokane,300,255,555,300795
2022-11-30,WA,Whatcom,2054,800,2854,148864
2018-01-31,WA,Clark,0,0,0,78578
2020-09-30,WA,Mason,0,0,0,20804
2022-01-31,WA,Asotin,0,0,0,6736
2018-08-31,WA,Douglas,45,31,76,27791
2019-10-31,WA,Whatcom,949,470,1419,151478
2017-11-30,WA,Skagit,1,0,1,31687
2018-02-28,WA,Wahkiakum,0,0,0,1673
2019-02-28,WA,Whatcom,785,380,1165,149641
2023-01-31,WA,Island,955,401,1356,61553
2018-07-31,WA,Stevens,11,25,36,31650
2021-07-31,CA,San Diego,17,7,24,2530
2019-08-31,WA,Franklin,0,0,0,19494
2017-04-30,WA,Jefferson,98,56,154,23744
2021-09-30,WA,Lewis,0,0,0,26704
2020-09-30,WA,Adams,0,0,0,5309
2017-10-31,WA,Garfield,0,0,0,943
2020-04-30,WA,Garfield,0,0,0,968
2017-10-31,WA,Thurston,0,0,0,53577
2017-01-31,WA,Skagit,1,0,1,31404
2018-04-30,WA,Grays Harbor,47,52,99,46287
2019-07-31,WA,Whatcom,2,0,2,42929
2021-06-30,WA,Spokane,0,0,0,102350
2019-05-31,WA,Skamania,0,0,0,4052
2021-11-30,WA,Douglas,106,53,159,28610
2022-03-31,CA,San Bernardino,1,1,2,337
2022-09-30,WA,Grays Harbor,224,166,390,48799
2023-02-28,WA,Benton,15,0,15,43323
2020-03-31,WA,Walla Walla,68,63,131,36237
2020-06-30,WA,Wahkiakum,0,0,0,1737
2022-09-30,WA,Thurston,2380,1102,3482,192946
2020-10-31,WA,Whitman,50,46,96,21981
2023-07-31,WA,Yakima,13,0,13,58999
2018-09-30,WA,Klickitat,24,32,56,15362
2019-05-31,WA,Snohomish,3372,1572,4944,530335
2018-04-30,WA,Ferry,0,0,0,3499
2022-10-31,WA,Mason,350,187,537,46978
2022-09-30,CA,Ventura,2,1,3,218
2019-11-30,WA,Wahkiakum,4,3,7,3037
2018-01-31,WA,Cowlitz,54,69,123,70972
2020-08-31,WA,Yakima,146,122,268,166128
2017-12-31,WA,Lincoln,2,5,7,7569
2020-01-31,CA,Riverside,4,1,5,641
2019-12-31,WA,Douglas,67,38,105,28299
2019-03-31,WA,Grays Harbor,69,80,149,47589
2020-09-30,WA,Skamania,0,0,0,4005
2017-05-31,WA,Walla Walla,0,0,0,13189
2023-04-30,WA,Mason,417,204,621,46162
2018-02-28,WA,Island,0,0,0,20828
2022-07-31,WA,Cowlitz,2,0,2,28483
2020-04-30,WA,Cowlitz,0,0,0,28765
2018-01-31,WA,Franklin,31,51,82,57013
2017-04-30,WA,Yakima,0,0,0,57219
2017-09-30,WA,Pierce,1012,898,1910,525165
2017-12-31,WA,Okanogan,7,18,25,25740
2018-12-31,WA,Wahkiakum,1,1,2,2979
2018-12-31,WA,Kitsap,946,544,1490,179830
2023-05-31,WA,King,684,2,686,174691
2020-05-31,WA,Columbia,4,3,7,2405
2022-11-30,WA,King,337,2,339,179007
2019-07-31,CA,San Diego,10,3,13,2733
2021-02-28,CA,San Joaquin,1,0,1,108
2020-07-31,WA,Whitman,45,49,94,22124
2017-02-28,WA,Clark,0,0,0,77521
2020-07-31,CA,San Diego,14,5,19,2756
2022-03-31,WA,Columbia,6,0,6,2448
2017-08-31,CA,Sacramento,1,0,1,345
2019-10-31,WA,Asotin,12,8,20,12644
2022-12-31,WA,Wahkiakum,26,13,39,3037
2018-04-30,CA,Riverside,2,2,4,706
2017-08-31,WA,Lewis,0,0,0,25013
2021-10-31,WA,Island,0,0,0,21569
2020-11-30,WA,Clallam,262,176,438,49872
2017-11-30,CA,Monterey,0,2,2,196
2019-05-31,WA,Asotin,12,8,20,12675
2022-07-31,WA,Grays Harbor,214,162,376,48927
2022-08-31,WA,Yakima,1,0,1,61393
2023-05-31,CA,Kern,1,1,2,164
2020-10-31,CA,Santa Clara,5,2,7,270
2019-11-30,WA,Grant,0,0,0,26953
2020-12-31,WA,Whitman,0,0,0,8508
2017-10-31,CA,Contra Costa,0,1,1,489
2021-09-30,WA,Grant,125,97,222,66876
2022-10-31,CA,Kern,1,1,2,186
2018-04-30,WA,Spokane,1,0,1,92061
2019-09-30,WA,King,20421,7282,27703,1394905
2018-06-30,WA,Jefferson,0,0,0,9548
2017-01-31,WA,Adams,1,1,2,12175
2018-09-30,WA,Ferry,0,0,0,3559
2022-01-31,WA,Garfield,0,0,0,995
2022-09-30,WA,Whitman,96,64,160,21991
2021-03-31,WA,Yakima,188,135,323,168230
2017-04-30,WA,Skamania,0,0,0,3874
2018-02-28,CA,San Mateo,0,1,1,138
2019-12-31,WA,Whitman,0,0,0,8579
2022-06-30,CA,Sonoma,0,1,1,74
2022-10-31,WA,Yakima,394,214,608,166433
2018-06-30,WA,King,13167,5678,18845,1371166
2017-07-31,WA,Walla Walla,0,0,0,13177
2018-03-31,WA,Chelan,0,0,0,21720
2019-04-30,WA,Yakima,93,103,196,164616
2017-02-28,WA,Cowlitz,50,46,96,69052
2022-01-31,CA,San Joaquin,1,1,2,90
2017-01-31,WA,Skamania,0,0,0,3908
2021-12-31,WA,Lincoln,0,0,0,4823
2018-10-31,CA,San Mateo,1,1,2,128
2017-08-31,CA,Los Angeles,3,2,5,1251
2018-02-28,WA,Skagit,1,0,1,31814
2019-09-30,WA,Wahkiakum,2,3,5,3049
2018-12-31,WA,Pacific,21,25,46,15834
2023-02-28,WA,Ferry,0,0,0,3565
2019-07-31,WA,Pend Oreille,0,0,0,5730
2017-12-31,CA,Marin,1,0,1,58
2021-10-31,WA,Chelan,0,0,0,23075
2021-03-31,WA,Pacific,39,40,79,15920
2017-01-31,WA,Kitsap,556,262,818,172401
2023-04-30,CA,Marin,0,1,1,26
2023-07-31,WA,King,58610,14725,73335,1297605
2021-11-30,WA,Benton,0,0,0,43650
2017-08-31,WA,Franklin,0,0,0,18234
2017-04-30,WA,Whitman,9,19,28,21964
2018-12-31,WA,Grays Harbor,62,72,134,47465
2020-03-31,CA,San Mateo,0,1,1,114
2021-06-30,WA,Whatcom,1419,602,2021,150844
2019-10-31,WA,Clark,1782,1016,2798,316964
2017-10-31,WA,Wahkiakum,0,0,0,1672
2020-07-31,CA,Sacramento,1,0,1,262
2021-08-31,CA,San Francisco,0,1,1,84
2022-07-31,WA,Pend Oreille,18,12,30,9043
2022-01-31,WA,Whatcom,1665,673,2338,149528
2020-01-31,CA,San Diego,10,5,15,2781
2021-02-28,WA,Island,546,296,842,62878
2017-01-31,CA,Los Angeles,3,1,4,1470
2020-02-29,CA,San Diego,11,5,16,2780
2018-12-31,CA,Tuolumne,0,1,1,13
2018-02-28,WA,Asotin,8,5,13,12588
2017-11-30,WA,Klickitat,0,0,0,8002
2021-10-31,WA,Walla Walla,132,82,214,36363
2023-06-30,WA,Ferry,21,4,25,4268
2021-03-31,WA,Pacific,0,0,0,7879
2022-11-30,CA,Orange,6,2,8,304
2022-07-31,CA,Santa Clara,10,2,12,207
2021-11-30,CA,Riverside,5,1,6,502
2021-06-30,CA,San Mateo,1,0,1,99
2020-01-31,WA,Snohomish,0,0,0,123641
2022-11-30,WA,Wahkiakum,25,13,38,3045
2017-08-31,WA,Ferry,0,0,0,3532
2017-06-30,WA,Grays Harbor,35,31,66,44778
2017-04-30,WA,Clark,755,471,1226,298474
2021-08-31,WA,Snohomish,6310,2137,8447,539419
2020-05-31,CA,San Diego,14,5,19,2741
2017-04-30,WA,Adams,2,3,5,12128
2021-06-30,WA,Pacific,45,53,98,16057
2018-12-31,WA,Asotin,12,9,21,12724
2023-07-31,WA,Yakima,511,253,764,161420
2021-06-30,WA,King,30495,9167,39662,1368513
2022-12-31,WA,Ferry,24,4,28,4344
2020-09-30,WA,Grant,0,0,0,27301
2020-04-30,CA,San Diego,13,5,18,2764
2018-02-28,WA,Garfield,0,0,0,942
2017-05-31,WA,Chelan,0,0,0,21248
2019-07-31,CA,Fresno,1,0,1,193
2017-07-31,WA,Franklin,26,47,73,55735
2023-03-31,CA,Riverside,6,0,6,375
2018-10-31,WA,Columbia,2,2,4,2432
2022-06-30,WA,Whitman,1,0,1,8572
2017-08-31,WA,Asotin,0,0,0,6515
2019-12-31,WA,Columbia,3,3,6,2449
2018-03-31,WA,Cowlitz,0,0,0,28271
2022-01-31,WA,King,36353,10406,46759,1356535
2023-07-31,WA,Stevens,2,0,2,18253
2021-05-31,WA,Clallam,1,0,1,22005
2022-03-31,WA,Skagit,731,326,1057,90496
2019-06-30,WA,Mason,124,122,246,47188
2021-12-31,WA,Benton,639,445,1084,136113
2021-12-31,WA,Grant,0,0,0,27999
2023-03-31,CA,Los Angeles,4,5,9,602
2017-12-31,CA,Orange,3,1,4,576
2018-01-31,WA,Benton,175,179,354,130623
2017-07-31,WA,Clark,0,0,0,77737
2023-01-31,CA,Santa Clara,9,2,11,167
2021-04-30,WA,Douglas,88,46,134,28472
2020-07-31,WA,Snohomish,0,0,0,124342
2022-01-31,WA,Walla Walla,146,89,235,36290
2023-05-31,WA,Adams,2,0,2,5262
2021-04-30,WA,Columbia,0,0,0,1560
2022-07-31,WA,Benton,780,462,1242,135328
2018-05-31,WA,Douglas,0,0,0,11900
2019-11-30,WA,Skamania,0,0,0,4096
2023-02-28,WA,Lewis,4,0,4,26200
2021-10-31,WA,Grays Harbor,0,0,0,21396
2019-01-31,WA,Adams,0,0,0,5142
2020-06-30,WA,Franklin,60,76,136,60644
2019-05-31,WA,Grant,39,59,98,64561
2019-10-31,CA,Shasta,1,0,1,40
2020-06-30,WA,King,24109,7712,31821,1371025
2020-07-31,WA,Pierce,2467,1697,4164,551463
2018-03-31,WA,Cowlitz,55,70,125,71222
2018-02-28,WA,Walla Walla,31,35,66,35386
2023-07-31,WA,Pend Oreille,30,15,45,8645
2018-04-30,WA,Yakima,0,0,0,58216
2017-02-28,CA,San Mateo,0,1,1,165
2017-02-28,CA,Santa Clara,5,3,8,424
2020-10-31,CA,Orange,5,3,8,461
2019-07-31,WA,Walla Walla,52,61,113,36208
2022-09-30,WA,King,43484,11789,55273,1345189
2023-06-30,CA,Sonoma,1,1,2,45
2020-10-31,CA,Placer,2,0,2,85
2021-11-30,WA,Mason,255,158,413,47799
2018-09-30,WA,Whatcom,2,0,2,42433
2020-03-31,WA,Walla Walla,0,0,0,13647
2019-04-30,WA,Whitman,29,45,74,22711
2018-06-30,CA,Tuolumne,0,1,1,11
2019-10-31,WA,Ferry,5,2,7,4425
2022-11-30,WA,Franklin,246,117,363,61801
2018-06-30,WA,Skagit,1,0,1,32042
2020-12-31,WA,Whitman,51,44,95,21905
2017-11-30,WA,Jefferson,0,0,0,9461
2018-03-31,WA,Stevens,0,0,0,18427
2018-07-31,WA,Lewis,0,0,0,25583
2021-10-31,WA,Klickitat,87,51,138,15357
2021-07-31,WA,Jefferson,0,0,0,9618
2022-01-31,WA,Stevens,58,47,105,30190
2023-02-28,WA,Clark,5174,2109,7283,313862
2021-04-30,WA,Walla Walla,108,71,179,36527
2020-01-31,WA,Whitman,42,48,90,22664
2017-09-30,WA,Grant,20,33,53,61457
2021-06-30,WA,Chelan,0,0,0,23127
2019-10-31,CA,Santa Cruz,1,0,1,36
2020-09-30,WA,Walla Walla,0,0,0,13789
2022-11-30,WA,Douglas,162,59,221,28510
2017-11-30,WA,Franklin,31,48,79,56681
2022-06-30,WA,Yakima,1,0,1,61408
2021-10-31,CA,Ventura,2,1,3,248
2022-06-30,CA,Los Angeles,8,8,16,745
2022-10-31,CA,Solano,2,0,2,148
2020-10-31,WA,Clark,2212,1121,3333,318837
2017-04-30,WA,Franklin,27,47,74,55348
2021-03-31,WA,San Juan,394,123,517,14117
2021-07-31,WA,Snohomish,6126,2100,8226,539757
2020-09-30,WA,Pacific,32,34,66,15716
2021-11-30,WA,Benton,625,435,1060,136011
2020-10-31,WA,Stevens,0,0,0,18696
2021-10-31,WA,Cowlitz,0,1,1,29069
2018-08-31,WA,Whitman,20,30,50,22680
2020-10-31,WA,Thurston,0,0,0,56300
2021-09-30,CA,Orange,5,2,7,397
2020-01-31,WA,Okanogan,32,30,62,26220
2020-06-30,WA,Island,1,0,1,21212
2020-10-31,WA,Whatcom,1169,531,1700,149671
2017-05-31,WA,Garfield,0,0,0,1287
2020-12-31,WA,Pierce,0,0,0,144789
2022-01-31,WA,Clark,3541,1572,5113,319486
2022-03-31,CA,Kern,0,1,1,190
2021-10-31,WA,Grant,133,95,228,66824
2019-06-30,CA,Santa Cruz,1,0,1,41
2019-06-30,WA,Chelan,0,0,0,22281
2022-07-31,CA,Kings,2,1,3,297
2022-01-31,CA,Monterey,0,1,1,134
2017-05-31,WA,Pacific,9,7,16,15138
2023-02-28,WA,Whitman,4,0,4,8658
2019-12-31,WA,Clark,1843,1043,2886,317733
2020-11-30,CA,Fresno,1,0,1,169
2020-03-31,CA,Sacramento,1,0,1,271
2019-02-28,WA,Benton,0,0,0,41547
2017-01-31,WA,Thurston,0,0,0,53340
2019-08-31,WA,Chelan,165,70,235,54453
2017-06-30,WA,Kitsap,1,0,1,52519
2023-05-31,WA,Garfield,0,0,0,964
2017-06-30,WA,Garfield,0,0,0,940
2018-05-31,CA,Monterey,0,1,1,187
2019-08-31,WA,San Juan,225,73,298,14441
2022-08-31,CA,Santa Clara,10,2,12,203
2021-12-31,CA,Fresno,1,0,1,155
2017-05-31,WA,Pend Oreille,0,0,0,5564
2023-04-30,CA,Sonoma,1,1,2,51
2018-12-31,WA,Chelan,140,61,201,54138
2021-01-31,WA,Skamania,34,23,57,8339
2018-09-30,WA,Chelan,117,59,176,53803
2021-12-31,WA,Clallam,1,0,1,22124
2019-03-31,WA,Clark,0,0,0,79992
2022-05-31,WA,Skagit,759,332,1091,90123
2017-01-31,WA,Yakima,36,49,85,159930
2017-04-30,WA,Ferry,0,0,0,3549
2018-03-31,WA,Whatcom,2,0,2,42069
2022-03-31,WA,Kittitas,225,74,299,29794
2022-05-31,WA,Spokane,1,0,1,102240
2018-09-30,WA,Snohomish,2516,1329,3845,524563
2020-10-31,WA,Skagit,1,0,1,32682
2017-06-30,WA,Douglas,0,0,0,11527
2022-03-31,CA,San Mateo,2,0,2,76
2019-01-31,WA,King,6,1,7,182396
2020-05-31,WA,Whatcom,1060,496,1556,149298
2023-06-30,WA,Grays Harbor,296,186,482,47792
2019-09-30,WA,Pacific,0,0,0,7676
2019-01-31,WA,Cowlitz,0,0,0,28728
2023-07-31,CA,San Diego,14,9,23,1711
2022-06-30,WA,Adams,1,0,1,5468
2019-12-31,WA,Cowlitz,118,107,225,73644
2017-12-31,WA,Whitman,17,20,37,22426
2021-05-31,WA,Asotin,0,0,0,6783
2019-04-30,WA,Skamania,0,0,0,4039
2022-02-28,WA,Clallam,393,243,636,50137
2018-11-30,WA,Whatcom,730,355,1085,149134
2017-12-31,WA,Kittitas,35,26,61,28449
2018-06-30,WA,Lincoln,0,0,0,4559
2019-11-30,CA,Shasta,1,0,1,38
2018-04-30,CA,Monterey,0,1,1,188
2018-10-31,WA,Franklin,35,66,101,58751
2022-02-28,WA,Mason,0,0,0,21184
2017-09-30,WA,Adams,3,3,6,12263
2023-07-31,WA,Pierce,7775,2805,10580,516969
2022-07-31,WA,Skamania,76,47,123,8163
2023-06-30,WA,Island,1074,439,1513,60607
2017-01-31,WA,Pend Oreille,0,0,0,5595
2021-08-31,WA,Chelan,364,102,466,54718
2019-04-30,WA,Benton,248,263,511,133307
2019-05-31,CA,Orange,6,1,7,527
2020-07-31,WA,Whitman,0,0,0,8507
2021-07-31,WA,Mason,216,139,355,48095
2017-03-31,WA,Yakima,36,50,86,159228
2022-06-30,WA,Ferry,19,4,23,4409
2021-10-31,WA,Whatcom,4,0,4,43778
2018-08-31,WA,Benton,0,0,0,41231
2021-01-31,CA,Los Angeles,10,11,21,927
2021-01-31,WA,Grays Harbor,133,126,259,48779
2021-12-31,WA,Wahkiakum,17,10,27,3082
2021-02-28,WA,Spokane,923,560,1483,321417
2022-08-31,WA,Ferry,0,0,0,3585
2020-05-31,WA,Yakima,0,0,0,59572
2018-04-30,WA,Benton,178,188,366,130946
2017-10-31,WA,Franklin,31,49,80,56508
2021-12-31,WA,Spokane,0,0,0,102792
2022-09-30,WA,Skagit,6,0,6,32229
2021-03-31,WA,Whatcom,4,0,4,43783
2023-03-31,WA,Grant,8,0,8,28019
2019-11-30,WA,Jefferson,0,0,0,9654
2020-03-31,WA,Yakima,0,0,0,59596
2022-01-31,WA,San Juan,482,151,633,14173
2018-01-31,WA,Skamania,11,8,19,8608
2018-03-31,WA,Pierce,1126,1053,2179,527857
2017-08-31,CA,Santa Clara,5,2,7,393
2023-03-31,WA,Kittitas,325,94,419,29410
2017-04-30,WA,San Juan,0,0,0,5551
2019-04-30,WA,Whitman,0,0,0,8517
2021-12-31,WA,Asotin,0,0,0,6755
2022-06-30,WA,Lewis,0,0,0,26412
2017-02-28,WA,Skagit,1,0,1,31404
2018-08-31,WA,Whitman,0,0,0,8505
2017-06-30,WA,Snohomish,1793,903,2696,513181
2017-11-30,WA,San Juan,126,41,167,13785
2022-10-31,WA,Walla Walla,3,0,3,13949
2023-07-31,WA,Wahkiakum,27,17,44,2972
2021-06-30,WA,Thurston,0,0,0,56575
2022-04-30,CA,Marin,0,1,1,30
2021-04-30,WA,Pend Oreille,14,5,19,9302
2020-03-31,WA,Stevens,33,33,66,31263
2018-08-31,WA,Stevens,0,0,0,18676
2018-02-28,WA,Whitman,18,21,39,22530
2019-09-30,WA,Walla Walla,59,63,122,36254
2019-07-31,WA,Walla Walla,0,0,0,13617
2017-06-30,WA,Douglas,34,26,60,26716
2018-12-31,WA,Cowlitz,72,94,166,72436
2020-11-30,CA,El Dorado,1,0,1,33
2017-06-30,WA,Chelan,67,37,104,52044
2023-04-30,WA,Kittitas,328,95,423,29339
2023-06-30,WA,San Juan,616,172,788,13654
2019-11-30,WA,Pacific,29,30,59,16115
2022-11-30,WA,Island,922,394,1316,61562
2018-06-30,WA,Clark,1009,719,1728,307969
2018-06-30,CA,Contra Costa,0,1,1,452
2017-05-31,WA,Grays Harbor,0,0,0,19898
2022-09-30,WA,King,241,2,243,179679
2021-10-31,CA,Fresno,1,0,1,160
2020-12-31,WA,Douglas,0,0,0,12494
2017-04-30,CA,Los Angeles,3,1,4,1345
2018-10-31,WA,Lewis,0,0,0,25611
2018-02-28,WA,Yakima,0,0,0,58125
2020-04-30,WA,Adams,0,0,0,5206
2023-02-28,WA,Columbia,0,0,0,1574
2020-03-31,CA,Santa Cruz,1,0,1,37
2020-06-30,WA,Clark,0,0,0,82225
2020-09-30,WA,Garfield,0,1,1,1348
2022-12-31,WA,Columbia,0,0,0,1587
2017-05-31,WA,Grays Harbor,31,30,61,44516
2022-12-31,WA,Garfield,1,3,4,1313
2018-06-30,CA,Santa Clara,7,0,7,375
2022-07-31,WA,Clark,9,0,9,82552
2022-02-28,WA,Stevens,0,0,0,18976
2020-12-31,WA,Kitsap,1556,756,2312,179832
2019-10-31,WA,Kitsap,1,0,1,54352
2017-09-30,WA,King,7,1,8,186365
2018-08-31,WA,Ferry,2,2,4,4420
2019-06-30,WA,Stevens,19,31,50,31694
2022-02-28,CA,Kings,2,1,3,311
2017-02-28,WA,Clark,695,434,1129,297935
2017-11-30,WA,Spokane,1,0,1,91421
2022-09-30,WA,Columbia,8,0,8,2439
2020-10-31,WA,Klickitat,0,0,0,8088
2017-03-31,WA,Wahkiakum,0,2,2,2849
2021-04-30,CA,Ventura,1,1,2,265
2018-02-28,CA,Los Angeles,5,3,8,1192
2018-04-30,WA,Skamania,0,0,0,3922
2019-02-28,WA,Island,0,0,0,21171
2019-09-30,CA,Orange,7,3,10,513
2023-02-28,WA,Klickitat,4,0,4,8261
2022-08-31,CA,Marin,0,1,1,27
2021-11-30,CA,Santa Cruz,1,0,1,22
2017-07-31,WA,Ferry,0,0,0,3526
2017-03-31,WA,Pierce,876,784,1660,526368
2019-07-31,WA,Columbia,2,2,4,2454
2018-08-31,WA,Columbia,0,0,0,1535
2019-01-31,WA,Pacific,0,0,0,7615
2019-04-30,WA,Jefferson,187,118,305,24901
2018-02-28,WA,Grays Harbor,0,0,0,20115
2022-09-30,WA,Clark,19,0,19,82316
2019-05-31,CA,Shasta,1,0,1,42
2018-06-30,CA,Los Angeles,7,4,11,1150
2018-02-28,WA,Jefferson,0,0,0,9511
2019-11-30,WA,Whatcom,2,0,2,43148
2018-02-28,WA,Garfield,1,0,1,1323
2021-01-31,WA,Pierce,2963,1790,4753,555715
2022-01-31,WA,King,14,1,15,182672
2022-10-31,WA,Whitman,103,65,168,21978
2020-08-31,WA,Skamania,31,22,53,8376
2019-04-30,WA,Walla Walla,46,57,103,36137
2018-05-31,WA,Pend Oreille,4,5,9,9508
2017-05-31,WA,Adams,0,0,0,5079
2022-03-31,CA,Orange,4,2,6,362
2018-02-28,WA,Adams,0,0,0,5139
2023-05-31,WA,Walla Walla,215,115,330,35196
2021-02-28,WA,Wahkiakum,8,6,14,3045
2022-08-31,WA,Spokane,10,0,10,102018
2020-05-31,WA,Pierce,0,0,0,141318
2017-05-31,WA,Snohomish,1739,867,2606,512625
2021-08-31,WA,Lewis,181,151,332,59647
2022-07-31,WA,Skagit,5,0,5,32300
2022-08-31,WA,Lewis,0,0,0,26330
2021-08-31,CA,Sonoma,0,1,1,82
2020-05-31,CA,Kern,0,1,1,225
2019-05-31,WA,Yakima,94,104,198,165012
2018-03-31,WA,Ferry,1,3,4,4404
2017-03-31,WA,Pacific,0,0,0,7480
2022-04-30,CA,Fresno,1,0,1,142
2020-09-30,CA,San Francisco,2,1,3,89
2018-12-31,WA,Walla Walla,41,52,93,36097
2022-08-31,WA,Snohomish,8928,2595,11523,531276
2022-12-31,WA,Skamania,89,52,141,8114
2019-11-30,CA,Kern,0,1,1,220
2022-08-31,WA,Okanogan,88,48,136,26317
2023-07-31,WA,Jefferson,12,0,12,9094
2019-02-28,WA,Douglas,0,0,0,12166
2022-10-31,WA,Snohomish,9424,2670,12094,531029
2022-08-31,WA,Douglas,141,60,201,28384
2018-11-30,WA,Adams,0,0,0,5160
2017-07-31,WA,Clallam,0,0,0,21043
2017-09-30,WA,Pend Oreille,3,4,7,9371
2017-12-31,CA,Alameda,0,1,1,352
2022-04-30,CA,Alameda,4,0,4,192
2020-12-31,WA,Franklin,85,83,168,61368
2020-07-31,WA,King,7,1,8,182955
2018-07-31,WA,Island,0,0,0,20994
2018-12-31,WA,Pacific,0,0,0,7614
2021-04-30,CA,Santa Clara,8,2,10,260
2021-01-31,WA,Yakima,178,129,307,167569
2023-02-28,WA,Spokane,2041,983,3024,323909
2017-04-30,WA,Klickitat,22,23,45,14768
2020-04-30,WA,Yakima,129,115,244,165261
2023-05-31,CA,San Bernardino,2,1,3,245
2021-05-31,WA,Benton,504,385,889,136106
2023-03-31,WA,Lewis,295,191,486,58567
2022-06-30,CA,San Diego,15,11,26,2238
2023-07-31,WA,Whitman,5,0,5,8455
2017-11-30,WA,Clark,840,558,1398,303188
2020-03-31,WA,Cowlitz,0,0,0,28852
2017-09-30,WA,Wahkiakum,0,0,0,1667
2018-07-31,WA,Cowlitz,0,0,0,28560
2021-06-30,WA,Grays Harbor,0,0,0,21450
2018-03-31,WA,Walla Walla,0,0,0,13311
2018-08-31,WA,Wahkiakum,1,1,2,2961
2017-01-31,WA,Kitsap,1,0,1,52380
2019-05-31,CA,Placer,1,0,1,105
2018-06-30,WA,Pierce,0,0,0,137831
2019-06-30,WA,Douglas,0,0,0,12182
2021-08-31,CA,Santa Clara,8,2,10,243
2020-02-29,CA,San Joaquin,1,0,1,135
2017-12-31,WA,Stevens,0,0,0,18379
2020-10-31,WA,Columbia,0,0,0,1532
2022-04-30,WA,Pierce,3,0,3,143016
2018-04-30,WA,Thurston,0,0,0,54065
2022-08-31,WA,Pend Oreille,0,0,0,5635
2021-02-28,WA,Wahkiakum,0,0,0,1782
2018-08-31,WA,Garfield,0,0,0,956
2019-10-31,WA,Cowlitz,112,106,218,73568
2019-02-28,WA,Okanogan,0,0,0,16468
2019-03-31,CA,Kern,0,1,1,225
2018-03-31,WA,Pierce,0,0,0,137102
2018-02-28,CA,Contra Costa,0,1,1,469
2020-01-31,CA,Santa Cruz,1,0,1,34
2017-08-31,WA,Grays Harbor,37,37,74,44965
2019-08-31,WA,Whitman,0,0,0,8627
2020-07-31,CA,Fresno,1,0,1,175
2022-06-30,WA,Island,818,379,1197,61948
2018-07-31,CA,Los Angeles,7,4,11,1140
2022-05-31,WA,Wahkiakum,0,0,0,1805
2023-07-31,WA,Wahkiakum,3,0,3,1728
2022-11-30,WA,Douglas,2,0,2,12811
2023-03-31,WA,Klickitat,6,0,6,8273
2022-09-30,WA,Lewis,1,0,1,26365
2019-01-31,WA,Asotin,0,0,0,6645
2022-06-30,WA,Kitsap,4,0,4,53663
2023-04-30,CA,Ventura,2,1,3,194
2023-07-31,CA,Marin,0,1,1,26
2017-08-31,WA,Snohomish,1847,942,2789,513730
2023-02-28,WA,Clallam,504,272,776,49281
2017-08-31,WA,Wahkiakum,0,2,2,2834
2019-11-30,CA,Tuolumne,0,1,1,11
2018-02-28,WA,Adams,5,4,9,12458
2018-03-31,WA,Lewis,0,0,0,25255
2020-01-31,WA,Grays Harbor,105,105,210,48505
2020-06-30,CA,Solano,1,0,1,209
2017-11-30,WA,Pacific,15,11,26,15334
2021-12-31,WA,Grant,137,98,235,66973
2019-09-30,WA,Snohomish,0,0,0,122968
2022-09-30,WA,Clark,4480,1890,6370,315618
2019-12-31,WA,Wahkiakum,4,3,7,3041
2019-03-31,WA,Wahkiakum,1,1,2,3008
2022-07-31,CA,Santa Cruz,1,0,1,21
2023-02-28,WA,San Juan,580,172,752,13878
2022-10-31,WA,Grant,2,0,2,28024
2019-08-31,WA,Ferry,0,0,0,3579
2023-03-31,WA,Snohomish,134,0,134,121787
2022-07-31,WA,Spokane,8,0,8,102044
2023-01-31,WA,San Juan,9,0,9,5904
2018-09-30,WA,Wahkiakum,1,1,2,2980
2018-08-31,WA,Okanogan,10,20,30,26065
2019-09-30,CA,Kern,0,1,1,217
2023-01-31,WA,Skamania,93,53,146,8110
2021-03-31,CA,Alameda,3,0,3,251
2017-10-31,WA,Adams,0,0,0,5135
2020-05-31,WA,Snohomish,0,0,0,123364
2020-07-31,WA,Klickitat,0,0,0,8117
2021-06-30,WA,Asotin,20,17,37,12728
2017-01-31,WA,Cowlitz,51,44,95,69109
2022-02-28,CA,San Joaquin,1,1,2,89
2021-09-30,WA,Skagit,1,0,1,32933
2019-12-31,WA,Klickitat,46,38,84,15674
2019-05-31,WA,San Juan,207,71,278,14357
2021-05-31,WA,Columbia,6,3,9,2476
2022-08-31,WA,Garfield,1,3,4,1322
2019-04-30,CA,San Mateo,2,1,3,122
2019-03-31,WA,Jefferson,179,118,297,24880
2019-02-28,WA,Grant,0,0,0,26315
2017-07-31,WA,Garfield,0,0,0,1296
2017-05-31,WA,Kitsap,595,302,897,172845
2022-11-30,CA,San Diego,17,10,27,2066
2023-07-31,WA,Columbia,10,1,11,2365
2020-12-31,WA,Klickitat,0,0,0,8088
2017-12-31,WA,Lewis,54,40,94,56571
2020-02-29,WA,Franklin,0,0,0,19897
2018-05-31,CA,San Mateo,1,1,2,134
2023-01-31,WA,Whatcom,37,0,37,42986
2017-08-31,WA,Skamania,10,7,17,8571
2023-06-30,WA,Island,32,0,32,20856
2021-11-30,CA,Sonoma,0,1,1,82
2020-11-30,WA,Pierce,2759,1756,4515,554918
2019-02-28,WA,Whitman,25,40,65,22756
2019-02-28,CA,San Diego,9,3,12,2628
2017-07-31,WA,Yakima,0,0,0,57469
2022-01-31,WA,Chelan,0,0,0,23062
2021-04-30,WA,Grays Harbor,0,0,0,21415
2020-12-31,WA,Stevens,0,0,0,18716
2021-08-31,WA,Thurston,0,0,0,56421
2018-04-30,WA,Whatcom,2,0,2,42122
2020-08-31,WA,Grant,66,75,141,65404
2020-02-29,WA,Skamania,0,0,0,4102
2017-12-31,WA,Yakima,59,75,134,162075
2019-06-30,CA,Solano,1,0,1,211
2022-06-30,WA,Lincoln,8,18,26,7710
2017-10-31,WA,Whatcom,2,0,2,41876
2021-12-31,WA,Adams,0,0,0,5419
2019-11-30,WA,Lincoln,0,0,0,4695
2018-01-31,WA,King,11619,4878,16497,1370831
2020-11-30,WA,Whitman,51,44,95,21963
2021-01-31,CA,Contra Costa,3,3,6,278
2018-03-31,CA,Santa Clara,6,1,7,377
2017-10-31,WA,Lewis,0,0,0,25209
2022-03-31,WA,Pend Oreille,0,0,0,5689
2018-07-31,WA,Benton,193,197,390,131733
2021-07-31,WA,Clallam,341,220,561,50460
2017-09-30,WA,Whitman,12,22,34,22193
2018-06-30,WA,Wahkiakum,1,2,3,2915
2017-04-30,WA,Skagit,1,0,1,31395
2020-05-31,WA,Chelan,0,0,0,22434
2022-06-30,WA,Stevens,0,0,0,18951
2017-07-31,WA,Island,0,0,0,20500
2017-06-30,WA,Whitman,0,0,0,8429
2018-10-31,WA,Snohomish,2637,1378,4015,525955
2021-09-30,WA,Cowlitz,0,1,1,29037
2020-11-30,WA,Lewis,0,0,0,26547
2023-05-31,WA,Klickitat,11,0,11,8198
2019-12-31,WA,Wahkiakum,0,0,0,1754
2020-02-29,WA,Garfield,0,1,1,1349
2019-12-31,WA,San Juan,0,0,0,5935
2019-12-31,CA,Solano,1,0,1,207
2022-03-31,CA,Solano,1,0,1,167
2021-02-28,WA,Thurston,0,0,0,56448
2018-11-30,WA,Mason,0,0,0,20190
2017-11-30,WA,Adams,3,5,8,12358
2020-05-31,WA,Grant,59,70,129,65207
2017-11-30,WA,Skamania,10,7,17,8576
2017-06-30,WA,Clallam,0,0,0,21016
2022-02-28,WA,San Juan,1,0,1,6017
2023-07-31,WA,San Juan,622,165,787,13491
2020-06-30,WA,Pierce,2380,1692,4072,549665
2020-09-30,WA,Wahkiakum,6,6,12,3016
2021-07-31,WA,Lincoln,0,0,0,4759
2021-03-31,WA,Lewis,130,134,264,59293
2017-08-31,WA,Garfield,0,0,0,932
2017-05-31,WA,Pacific,0,0,0,7463
2019-08-31,WA,Garfield,0,1,1,1306
2017-11-30,WA,Whitman,0,0,0,8437
2018-06-30,WA,Island,197,188,385,62531
2020-01-31,WA,Whatcom,1032,486,1518,151794
2021-05-31,WA,Kittitas,0,0,0,14768
2023-07-31,WA,Jefferson,571,261,832,23782
2018-08-31,WA,Clallam,128,115,243,50115
2020-01-31,WA,Walla Walla,0,0,0,13710
2019-01-31,WA,Grant,33,53,86,64365
2018-11-30,WA,San Juan,0,0,0,5805
2021-02-28,WA,Franklin,0,0,0,20510
2019-11-30,WA,Clallam,195,153,348,50908
2018-05-31,WA,Mason,77,93,170,45592
2019-08-31,WA,Whatcom,902,450,1352,151212
2023-03-31,WA,Columbia,8,1,9,2416
2020-06-30,CA,San Joaquin,1,0,1,127
2019-05-31,WA,Garfield,1,1,2,1293
2017-04-30,CA,Monterey,0,1,1,210
2017-10-31,WA,Skamania,10,7,17,8571
2017-09-30,CA,Riverside,1,2,3,751
2023-04-30,CA,Contra Costa,0,3,3,193
2022-01-31,WA,Cowlitz,0,1,1,28923
2017-08-31,WA,Columbia,0,0,0,1541
2019-06-30,WA,Skagit,1,0,1,32442
2018-03-31,CA,Riverside,2,2,4,706
2023-02-28,WA,Island,20,0,20,21105
2022-04-30,WA,Mason,294,178,472,47516
2019-06-30,CA,Contra Costa,2,2,4,386
2022-10-31,WA,Pierce,5747,2449,8196,540967
2023-07-31,WA,Franklin,6,0,6,20274
2017-02-28,WA,Adams,0,0,0,5071
2019-02-28,CA,Tuolumne,0,1,1,12
2023-05-31,CA,Marin,0,1,1,27
2018-04-30,WA,Columbia,2,1,3,2414
2023-04-30,WA,Wahkiakum,27,16,43,3044
2023-07-31,CA,Santa Cruz,1,0,1,11
2021-11-30,WA,Snohomish,2,0,2,125685
2017-08-31,WA,Kittitas,27,21,48,27891
2023-06-30,WA,Douglas,5,0,5,12829
2021-02-28,WA,King,6,1,7,184321
2021-06-30,WA,Okanogan,0,0,0,16757
2018-10-31,WA,Whitman,0,0,0,8531
2019-11-30,WA,Lewis,109,103,212,59509
2021-01-31,WA,Wahkiakum,0,0,0,1769
2021-04-30,WA,Chelan,0,0,0,23068
2023-02-28,WA,Yakima,445,240,685,166120
2021-10-31,WA,Asotin,21,17,38,12770
2017-11-30,WA,Pend Oreille,3,4,7,9428
2021-09-30,CA,San Diego,16,8,24,2494
2022-03-31,CA,Ventura,2,1,3,234
2018-05-31,WA,Whatcom,612,281,893,147196
2022-12-31,WA,Cowlitz,405,190,595,70330
2017-09-30,WA,Okanogan,5,18,23,25690
2021-07-31,WA,Douglas,100,51,151,28504
2018-04-30,WA,Douglas,41,32,73,27438
2018-01-31,WA,Grant,0,0,0,25641
2017-02-28,WA,Benton,134,133,267,127653
2022-10-31,WA,Thurston,30,0,30,54906
2018-10-31,WA,Adams,0,0,0,5151
2023-02-28,WA,Kitsap,2890,1171,4061,176810
2020-03-31,WA,San Juan,0,0,0,5932
2020-02-29,WA,Jefferson,230,139,369,25171
2021-01-31,WA,Grant,0,0,0,27594
2018-07-31,WA,Spokane,1,0,1,92869
2020-11-30,WA,Cowlitz,0,0,0,28871
2019-02-28,WA,Pierce,0,0,0,138931
2022-01-31,WA,Snohomish,3,0,3,125304
2022-04-30,WA,Walla Walla,163,92,255,36040
2017-12-31,WA,Stevens,10,21,31,31533
2021-07-31,CA,Fresno,1,0,1,165
2021-06-30,WA,Whatcom,4,0,4,43913
2022-07-31,WA,Thurston,2242,1065,3307,193613
2018-02-28,WA,Clallam,109,101,210,49356
2017-02-28,WA,Mason,0,0,0,19196
2017-05-31,WA,Wahkiakum,0,2,2,2837
2020-12-31,CA,San Francisco,1,1,2,90
2017-01-31,WA,Grant,0,0,0,25039
2018-05-31,WA,Kittitas,0,0,0,14024
2021-05-31,WA,Lewis,157,135,292,59809
2021-10-31,WA,Grant,0,0,0,28018
2018-11-30,WA,Asotin,0,0,0,6620
2021-08-31,WA,Skamania,52,38,90,8389
2020-06-30,WA,San Juan,302,93,395,13968
2017-06-30,WA,Franklin,0,0,0,18122
2017-03-31,WA,Yakima,0,0,0,57266
2020-01-31,CA,Alameda,4,1,5,285
2020-09-30,CA,Santa Clara,6,2,8,276
2021-05-31,WA,Pierce,3382,1941,5323,559989
2020-04-30,WA,Ferry,5,3,8,4331
2022-01-31,WA,Lewis,213,165,378,59516
2018-12-31,WA,Jefferson,168,106,274,24838
2020-03-31,WA,Mason,0,0,0,20576
2018-11-30,WA,Whatcom,2,0,2,42656
2018-04-30,WA,Thurston,523,444,967,191803
2021-09-30,WA,Walla Walla,128,82,210,36440
2022-03-31,WA,Jefferson,408,207,615,24697
2020-02-29,WA,Whitman,0,0,0,8555
2018-02-28,WA,Columbia,0,0,0,1535
2020-11-30,WA,Yakima,166,122,288,167009
2021-02-28,WA,Grant,90,86,176,66076
2022-07-31,CA,Contra Costa,0,4,4,231
2023-06-30,WA,Stevens,1,0,1,18505
2021-05-31,WA,San Juan,423,131,554,14216
2018-06-30,CA,Alameda,0,1,1,347
2023-03-31,WA,Walla Walla,209,112,321,35444
2021-10-31,WA,Wahkiakum,17,8,25,3065
2017-06-30,CA,Santa Clara,5,2,7,400
2022-03-31,CA,Fresno,1,0,1,146
2020-12-31,WA,Skagit,497,238,735,91428
2018-01-31,WA,Pend Oreille,4,4,8,9441
2018-07-31,WA,Garfield,1,1,2,1320
2023-05-31,WA,Wahkiakum,26,17,43,3018
2017-07-31,WA,Kittitas,0,0,0,13581
2017-08-31,WA,Ferry,1,1,2,4396
2023-07-31,WA,Lincoln,18,19,37,7476
2021-04-30,WA,Island,0,0,0,21561
2021-12-31,CA,Monterey,0,1,1,136
2021-03-31,WA,Ferry,0,0,0,3623
2022-11-30,WA,Chelan,11,0,11,23139
2020-10-31,WA,Ferry,0,0,0,3596
2018-08-31,WA,Pacific,19,22,41,15677
2022-05-31,CA,Placer,2,0,2,64
2017-07-31,WA,King,10255,4174,14429,1373311
2021-01-31,WA,Snohomish,5177,1876,7053,538376
2021-12-31,WA,Stevens,0,0,0,18940
2021-07-31,CA,San Mateo,1,0,1,95
2022-05-31,WA,Asotin,23,19,42,12730
2021-01-31,CA,Santa Clara,7,2,9,263
2022-11-30,CA,San Joaquin,1,0,1,75
2021-12-31,WA,Asotin,22,17,39,12718
2022-04-30,WA,Columbia,0,0,0,1588
2020-03-31,CA,Riverside,3,1,4,639
2017-04-30,WA,San Juan,98,35,133,13479
2021-08-31,CA,Sacramento,2,0,2,212
2023-03-31,WA,Grant,253,113,366,66819
2022-09-30,CA,Santa Cruz,1,0,1,19
2021-06-30,CA,Sacramento,2,0,2,214
2022-10-31,WA,Grays Harbor,2,0,2,21098
2022-10-31,WA,Chelan,8,0,8,23087
2019-01-31,WA,Cowlitz,79,96,175,72557
2018-09-30,WA,Skamania,0,0,0,3967
2020-03-31,WA,Lewis,105,108,213,59209
2022-03-31,WA,Walla Walla,0,0,0,14031
2018-10-31,CA,Riverside,2,2,4,678
2020-02-29,WA,Skagit,1,0,1,32559
2018-07-31,WA,Lewis,83,59,142,57814
2022-12-31,WA,Columbia,7,1,8,2441
2022-02-28,WA,Benton,664,451,1115,135846
2017-02-28,WA,Douglas,30,19,49,26547
2018-09-30,WA,Pacific,18,22,40,15733
2018-12-31,WA,Pend Oreille,0,0,0,5738
2020-06-30,WA,Spokane,730,487,1217,315451
2019-07-31,WA,Kittitas,79,41,120,29679
2020-02-29,CA,Riverside,3,1,4,643
2019-01-31,WA,Adams,5,6,11,12742
2019-11-30,WA,Walla Walla,0,0,0,13674
2020-12-31,WA,Kitsap,0,0,0,54371
2019-01-31,WA,Clark,1313,868,2181,312092
2022-07-31,WA,Spokane,1676,864,2540,324816
2018-06-30,WA,Adams,5,5,10,12616
2019-10-31,WA,Franklin,53,76,129,60628
2022-07-31,WA,Clallam,432,246,678,49651
2018-01-31,WA,Mason,0,0,0,19646
2021-01-31,WA,Adams,10,6,16,12971
2020-12-31,CA,Santa Clara,7,2,9,267
2017-01-31,WA,Whitman,8,19,27,21936
2020-10-31,CA,Fresno,1,0,1,174
2020-10-31,WA,Walla Walla,86,65,151,36014
2020-12-31,WA,Lewis,123,122,245,58843
2023-05-31,WA,Chelan,29,0,29,22965
2022-10-31,WA,Pend Oreille,0,0,0,5614
2019-11-30,WA,Wahkiakum,0,0,0,1752
2020-01-31,WA,Chelan,0,0,0,22573
2020-05-31,WA,Okanogan,0,0,0,16391
2017-01-31,CA,Santa Clara,5,3,8,460
2018-12-31,WA,Jefferson,0,0,0,9606
2021-12-31,WA,Island,714,340,1054,62768
2017-09-30,CA,Los Angeles,5,2,7,1234
2020-11-30,WA,Adams,0,0,0,5325
2020-11-30,WA,Mason,0,0,0,20860
2019-08-31,WA,Adams,0,0,0,5138
2018-09-30,WA,Wahkiakum,0,0,0,1691
2019-10-31,WA,Spokane,616,464,1080,314332
2020-12-31,CA,Los Angeles,10,11,21,939
2021-07-31,WA,San Juan,0,0,0,5955
2019-12-31,WA,Columbia,0,0,0,1537
2021-09-30,CA,Sacramento,2,0,2,218
2018-08-31,WA,Lewis,0,0,0,25605
2021-06-30,WA,Pacific,0,0,0,7965
2017-11-30,WA,Columbia,0,0,0,1537
2018-02-28,WA,Cowlitz,0,0,0,28183
2020-05-31,WA,Grays Harbor,106,111,217,48015
2020-12-31,WA,Columbia,5,3,8,2441
2022-09-30,WA,Pacific,0,0,0,7871
2017-09-30,WA,Lincoln,0,0,0,4472
2020-08-31,WA,Spokane,1,0,1,99446
2017-09-30,WA,Spokane,1,0,1,91172
2020-02-29,WA,Okanogan,34,31,65,26121
2020-09-30,CA,Sacramento,1,0,1,251
2023-04-30,WA,King,53639,13733,67372,1318485
2017-08-31,WA,Chelan,72,36,108,52309
2018-08-31,WA,Franklin,0,0,0,18794
2020-03-31,WA,Skagit,1,0,1,32552
2017-01-31,WA,Douglas,0,0,0,11426
2022-04-30,WA,Wahkiakum,0,0,0,1817
2018-10-31,WA,Columbia,0,0,0,1518
2020-11-30,WA,Mason,169,135,304,47500
2022-06-30,WA,Adams,17,10,27,12936
2021-06-30,WA,Wahkiakum,15,8,23,3109
2017-06-30,WA,Snohomish,1,0,1,121886
2022-01-31,CA,Sonoma,0,1,1,75
2022-05-31,CA,San Luis Obispo,1,0,1,54
2021-06-30,CA,San Francisco,0,1,1,85
2021-10-31,WA,Lewis,194,158,352,59631
2017-01-31,CA,Monterey,0,1,1,232
2018-03-31,WA,Ferry,0,0,0,3504
2017-12-31,WA,Columbia,0,0,0,1540
2019-03-31,WA,Chelan,144,67,211,54156
2022-10-31,WA,Clark,31,0,31,82151
2019-03-31,WA,Snohomish,3195,1519,4714,527994
2017-09-30,WA,Lewis,53,38,91,56022
2022-08-31,WA,Garfield,0,0,0,977
2018-12-31,WA,Snohomish,2915,1437,4352,527237
2017-12-31,WA,King,8,1,9,185056
2020-12-31,WA,Grant,0,0,0,27505
2018-01-31,CA,Tuolumne,0,1,1,14
2022-12-31,WA,San Juan,561,170,731,13907
2021-09-30,WA,Kittitas,0,0,0,14782
2018-07-31,WA,Grant,0,0,0,25943
2017-02-28,WA,Franklin,0,0,0,17907
2020-02-29,WA,Okanogan,0,0,0,16498
2018-12-31,WA,Chelan,0,0,0,22052
2017-04-30,WA,Adams,0,0,0,5072
2021-04-30,WA,Asotin,19,14,33,12659
2020-07-31,WA,Skagit,423,223,646,91309
2022-05-31,WA,Grays Harbor,205,158,363,49085
2020-06-30,WA,Lewis,102,111,213,58176
2019-01-31,WA,Franklin,49,68,117,59324
2021-08-31,WA,Wahkiakum,16,8,24,3079
2022-04-30,CA,Santa Cruz,1,0,1,24
2017-01-31,WA,Columbia,0,1,1,2331
2019-02-28,CA,Fresno,1,0,1,187
2021-02-28,CA,San Francisco,1,1,2,91
2021-05-31,WA,Klickitat,0,0,0,8263
2018-02-28,WA,Yakima,61,79,140,162333
2019-08-31,WA,Adams,5,5,10,12843
2021-06-30,WA,Skamania,0,0,0,4029
2017-04-30,WA,Lewis,46,33,79,55192
2023-06-30,CA,Santa Clara,8,1,9,137
2022-08-31,CA,Sonoma,0,1,1,69
2020-07-31,WA,Cowlitz,0,0,0,28879
2022-07-31,WA,Asotin,24,19,43,12650
2019-08-31,CA,Solano,1,0,1,208
2021-03-31,WA,Thurston,1432,824,2256,197465
2023-06-30,WA,Whitman,4,0,4,8514
2020-10-31,WA,San Juan,0,0,0,5864
2021-12-31,CA,Santa Cruz,1,0,1,23
2023-06-30,WA,Garfield,0,0,0,957
2022-10-31,WA,Whatcom,20,0,20,43123
2019-01-31,WA,Wahkiakum,1,1,2,3006
2018-07-31,WA,Cowlitz,57,77,134,71871
2017-07-31,WA,Kitsap,622,324,946,173384
2019-06-30,CA,San Mateo,2,1,3,115
2021-09-30,CA,Sonoma,0,1,1,82
2017-09-30,WA,Whitman,0,0,0,8428
2023-04-30,WA,Asotin,33,21,54,12339
2020-09-30,WA,Clark,2174,1098,3272,318408
2022-08-31,WA,Walla Walla,179,104,283,35818
2017-07-31,WA,Whitman,12,19,31,22108
2019-10-31,CA,San Mateo,1,1,2,120
2019-11-30,WA,Jefferson,212,132,344,25183
2021-12-31,WA,Adams,17,14,31,13083
2022-03-31,WA,Cowlitz,0,1,1,28868
2017-04-30,WA,Whatcom,2,0,2,41449
2018-03-31,CA,San Mateo,1,1,2,135
2018-07-31,WA,Grant,33,47,80,63265
2020-03-31,WA,Skagit,391,216,607,92155
2019-08-31,CA,Fresno,1,0,1,193
2021-08-31,WA,Garfield,0,0,0,1003
2019-03-31,CA,Los Angeles,7,5,12,1089
2020-05-31,WA,Franklin,0,0,0,19869
2018-05-31,WA,Okanogan,0,0,0,16409
2023-06-30,WA,Wahkiakum,27,17,44,3011
2022-09-30,WA,Benton,833,480,1313,135629
2022-02-28,WA,Skagit,716,316,1032,90675
2018-07-31,WA,Columbia,0,0,0,1530
2023-07-31,WA,King,780,2,782,170537
2022-03-31,WA,Ferry,0,0,0,3571
2022-09-30,CA,Monterey,1,1,2,118
2017-05-31,WA,Wahkiakum,0,0,0,1643
2022-09-30,CA,Napa,0,1,1,10
2017-10-31,WA,Grays Harbor,38,41,79,45374
2018-04-30,WA,Cowlitz,55,73,128,71356
2019-07-31,WA,Thurston,0,0,0,55259
2020-07-31,WA,Pacific,0,0,0,7714
2021-08-31,CA,Kern,0,1,1,203
2020-11-30,WA,Skagit,1,0,1,32715
2020-12-31,WA,Lewis,0,0,0,26622
2021-05-31,WA,Skamania,0,0,0,4030
2017-11-30,WA,Thurston,457,380,837,189509
2022-12-31,WA,Skamania,0,0,0,3884
2021-10-31,WA,Adams,0,0,0,5409
2019-11-30,WA,Island,363,251,614,63666
2023-07-31,CA,Ventura,1,1,2,182
2017-06-30,WA,Walla Walla,0,0,0,13205
2022-10-31,WA,Jefferson,5,0,5,9394
2018-03-31,WA,Douglas,42,33,75,27415
2022-05-31,CA,Fresno,1,0,1,137
2022-03-31,CA,San Diego,14,8,22,2332
2018-11-30,WA,Garfield,1,1,2,1331
2022-08-31,CA,Placer,2,0,2,63
2018-08-31,WA,Yakima,0,0,0,58619
2022-01-31,WA,Okanogan,70,47,117,26533
2021-12-31,WA,Whatcom,4,0,4,43696
2023-04-30,WA,Grays Harbor,4,0,4,20911
2021-08-31,WA,Pierce,0,0,0,145668
2022-08-31,WA,Island,9,0,9,21330
2022-02-28,WA,Thurston,1970,990,2960,196039
2019-01-31,WA,Franklin,0,0,0,19128
2017-09-30,WA,Wahkiakum,0,2,2,2836
2022-06-30,WA,Mason,1,0,1,21067
2021-08-31,WA,Walla Walla,0,0,0,14079
2021-09-30,WA,Mason,239,151,390,47982
2019-06-30,WA,Chelan,157,68,225,54354
2022-09-30,WA,Pacific,70,74,144,15784
2018-10-31,WA,Yakima,0,0,0,58757
2020-04-30,WA,Mason,0,0,0,20531
2021-09-30,WA,Columbia,7,2,9,2451
2020-04-30,CA,Fresno,1,0,1,183
2021-03-31,CA,San Mateo,1,1,2,102
2022-09-30,WA,Cowlitz,368,180,548,70395
2018-01-31,WA,Garfield,1,0,1,1329
2019-02-28,WA,Yakima,0,0,0,58797
2021-11-30,WA,Pend Oreille,0,0,0,5696
2022-10-31,CA,Placer,2,0,2,58
2021-02-28,WA,Columbia,0,0,0,1543
2019-05-31,WA,Walla Walla,0,0,0,13613
2020-07-31,WA,Chelan,0,0,0,22628
2022-09-30,WA,Klickitat,2,0,2,8263
2023-01-31,WA,Whitman,120,70,190,22014
2020-06-30,WA,Cowlitz,0,0,0,28868
2019-02-28,WA,Island,294,231,525,63179
2022-02-28,CA,Contra Costa,1,4,5,259
2021-12-31,CA,Solano,1,0,1,173
2022-09-30,WA,Grant,200,108,308,66776
2020-08-31,WA,Columbia,0,0,0,1526
2022-08-31,WA,Pacific,70,72,142,15797
2019-09-30,CA,Riverside,4,1,5,650
2019-04-30,WA,Chelan,0,0,0,22173
2022-11-30,CA,San Bernardino,1,1,2,290
2017-02-28,WA,Ferry,0,0,0,3562
2018-02-28,WA,Ferry,0,0,0,3527
2020-02-29,WA,Pierce,2253,1684,3937,551186
2021-04-30,WA,Whatcom,4,0,4,43870
2017-10-31,WA,Ferry,0,0,0,3549
2021-06-30,CA,Santa Clara,8,2,10,245
2018-11-30,WA,Pierce,0,0,0,139061
2021-07-31,WA,Adams,0,0,0,5392
2022-04-30,WA,Skamania,0,0,0,3981
2022-12-31,WA,Island,930,398,1328,61576
2021-07-31,WA,Wahkiakum,15,8,23,3091
2018-11-30,WA,Pend Oreille,5,5,10,9557
2017-10-31,WA,San Juan,0,0,0,5569
2020-12-31,CA,Sacramento,2,0,2,234
2017-04-30,WA,Lincoln,0,0,0,4464
2017-12-31,WA,Pend Oreille,0,0,0,5618
2022-01-31,WA,Spokane,0,0,0,102647
2022-10-31,WA,Asotin,0,0,0,6692
2023-06-30,CA,San Bernardino,2,1,3,241
2021-12-31,WA,Pend Oreille,18,9,27,9129
2018-04-30,WA,San Juan,141,53,194,13961
2021-12-31,WA,Jefferson,0,0,0,9599
2021-04-30,WA,Stevens,0,0,0,18874
2017-06-30,CA,Alameda,1,1,2,365
2023-06-30,WA,Grant,277,126,403,66206
2023-03-31,WA,Ferry,0,0,0,3563
2022-06-30,WA,Okanogan,1,0,1,16648
2022-06-30,WA,Jefferson,434,217,651,24594
2020-01-31,WA,Stevens,0,0,0,18790
2017-02-28,WA,Kittitas,0,0,0,13383
2020-11-30,WA,King,6,1,7,184180
2017-10-31,WA,Douglas,0,0,0,11656
2018-03-31,CA,Monterey,0,2,2,190
2022-12-31,WA,Mason,6,0,6,20861
2022-06-30,CA,Kern,0,1,1,186
2018-11-30,WA,Wahkiakum,0,0,0,1704
2020-10-31,WA,Pierce,0,0,0,144394
2018-04-30,WA,Garfield,1,0,1,1330
2021-12-31,CA,Santa Clara,7,1,8,227
2019-06-30,WA,Skamania,0,0,0,4062
2020-12-31,WA,Lincoln,5,12,17,7644
2021-11-30,WA,Wahkiakum,0,0,0,1817
2018-02-28,WA,Whatcom,1,0,1,42039
2019-03-31,WA,Clallam,0,0,0,21617
2021-09-30,WA,Franklin,138,100,238,62127
2022-07-31,CA,Kern,0,1,1,186
2017-07-31,CA,Alameda,1,1,2,358
2021-09-30,WA,Yakima,257,164,421,168958
2018-04-30,WA,Walla Walla,0,0,0,13332
2017-07-31,WA,Mason,0,0,0,19261
2020-05-31,WA,Lewis,0,0,0,26001
2023-06-30,CA,Napa,0,1,1,8
2019-02-28,WA,Kittitas,73,37,110,29446
2022-02-28,CA,Monterey,0,1,1,130
2018-09-30,WA,Stevens,0,0,0,18680
2020-09-30,CA,Fresno,1,0,1,173
2017-05-31,WA,San Juan,0,0,0,5541
2021-03-31,WA,Chelan,304,94,398,54537
2017-09-30,WA,Stevens,8,22,30,31547
2018-06-30,WA,Garfield,1,1,2,1316
2020-05-31,WA,Clark,2003,1055,3058,317495
2021-02-28,WA,Kittitas,142,53,195,29825
2017-05-31,WA,Lewis,49,33,82,55363
2022-11-30,WA,San Juan,7,0,7,5939
2021-07-31,WA,Yakima,236,161,397,169309
2019-01-31,WA,Benton,232,243,475,133224
2018-03-31,WA,Jefferson,132,88,220,24289
2021-06-30,WA,Grant,0,0,0,27912
2022-07-31,WA,Whitman,2,0,2,8570
2019-12-31,WA,Pend Oreille,0,0,0,5771
2022-06-30,WA,Island,4,0,4,21382
2023-02-28,WA,Snohomish,122,0,122,122092
2019-05-31,WA,Lewis,97,93,190,59034
2018-04-30,WA,Cowlitz,0,0,0,28292
2017-02-28,WA,Franklin,26,42,68,55221
2020-07-31,WA,Walla Walla,77,65,142,35905
2017-10-31,WA,Yakima,0,0,0,57813
2022-11-30,WA,Pierce,71,0,71,139968
2018-04-30,WA,Mason,71,87,158,45392
2022-07-31,WA,Ferry,0,0,0,3566
2018-01-31,WA,Snohomish,2073,1094,3167,518066
2018-05-31,WA,Whitman,19,27,46,22578
2018-05-31,WA,Okanogan,8,19,27,25886
2018-04-30,WA,Pacific,14,19,33,15488
2021-01-31,WA,Grays Harbor,0,0,0,21244
2019-06-30,WA,Clark,0,0,0,80332
2019-09-30,WA,Mason,133,129,262,47444
2021-12-31,WA,Jefferson,382,194,576,24756
2020-04-30,WA,Klickitat,0,0,0,8193
2022-08-31,WA,Ferry,20,4,24,4399
2022-09-30,WA,Chelan,495,135,630,54143
2018-07-31,CA,San Mateo,1,1,2,130
2019-02-28,WA,Lewis,0,0,0,25698
2023-02-28,WA,Stevens,2,0,2,18777
2023-03-31,CA,Ventura,2,1,3,196
2021-09-30,WA,Skagit,641,291,932,91682
2021-09-30,WA,Clark,3150,1486,4636,321804
2021-12-31,WA,Ferry,14,3,17,4442
2020-09-30,CA,Placer,2,0,2,85
2021-03-31,WA,Kittitas,146,55,201,29891
2019-12-31,WA,Cowlitz,0,0,0,29035
2018-01-31,WA,Kittitas,36,27,63,28637
2021-01-31,WA,Cowlitz,0,0,0,28973
2019-09-30,CA,Shasta,1,0,1,39
2017-01-31,WA,Yakima,0,0,0,57337
2021-12-31,WA,Thurston,0,0,0,56065
2020-01-31,WA,Garfield,0,1,1,1321
2022-02-28,CA,Santa Clara,8,1,9,227
2020-06-30,WA,Island,420,268,688,62807
2019-12-31,WA,Skagit,363,213,576,92637
2018-10-31,CA,Orange,5,1,6,547
2018-07-31,WA,Pierce,0,0,0,138077
2019-08-31,CA,Riverside,3,2,5,653
2021-12-31,CA,Alameda,4,0,4,210
2021-06-30,WA,Benton,518,394,912,136405
2021-12-31,WA,Kittitas,0,0,0,14794
2021-09-30,WA,Ferry,10,3,13,4403
2019-06-30,WA,Benton,259,279,538,133796
2019-03-31,WA,Columbia,0,0,0,1527
2017-12-31,WA,Asotin,0,0,0,6543
2020-07-31,WA,Thurston,0,0,0,55895
2019-12-31,CA,San Diego,9,3,12,2797
2018-06-30,CA,Sacramento,1,0,1,299
2017-10-31,WA,Grays Harbor,0,0,0,20007
2020-09-30,WA,San Juan,331,100,431,13907
2020-03-31,WA,Thurston,0,0,0,55680
2018-05-31,WA,Wahkiakum,1,2,3,2901
2019-01-31,WA,Pend Oreille,5,5,10,9538
2019-01-31,WA,Columbia,2,2,4,2423
2020-09-30,CA,El Dorado,1,0,1,33
2023-02-28,CA,Marin,0,1,1,27
2019-10-31,WA,Stevens,29,28,57,31624
2017-06-30,WA,San Juan,107,40,147,13551
2017-06-30,WA,Kitsap,605,319,924,173378
2019-12-31,WA,Lewis,106,102,208,59556
2017-03-31,WA,Grant,0,0,0,25045
2017-04-30,WA,Grays Harbor,0,0,0,19850
2021-12-31,WA,Whitman,67,59,126,21978
2022-04-30,WA,Island,779,367,1146,62227
2021-10-31,WA,Whatcom,1581,646,2227,150431
2022-09-30,WA,Lincoln,10,16,26,7725
2021-08-31,WA,Grant,0,0,0,27997
2019-05-31,CA,Riverside,2,2,4,658
2021-03-31,WA,Klickitat,0,0,0,8173
2021-06-30,WA,Clark,0,0,0,84343
2021-02-28,WA,Lewis,0,0,0,26704
2018-06-30,WA,Lewis,80,59,139,57688
2023-06-30,CA,San Diego,16,9,25,1770
2020-07-31,WA,Mason,0,0,0,20714
2020-11-30,WA,Asotin,0,0,0,6665
2018-11-30,WA,Whitman,0,0,0,8531
2023-07-31,WA,Columbia,0,0,0,1509
2019-04-30,WA,Pierce,0,0,0,139350
2020-01-31,WA,Chelan,213,77,290,54617
2017-04-30,WA,Okanogan,3,16,19,25595
2019-06-30,WA,Ferry,5,2,7,4388
2023-01-31,WA,Grays Harbor,260,164,424,48595
2019-04-30,WA,Columbia,2,2,4,2441
2022-06-30,CA,Monterey,1,1,2,126
2020-12-31,CA,San Mateo,1,1,2,107
2018-08-31,WA,Kitsap,1,0,1,53439
2018-08-31,WA,Kittitas,0,0,0,14113
2022-09-30,CA,San Diego,17,10,27,2135
2021-11-30,WA,Stevens,54,43,97,30313
2021-01-31,CA,Riverside,4,1,5,582
2017-06-30,CA,Orange,3,1,4,627
2021-06-30,WA,Asotin,0,0,0,6792
2018-01-31,WA,Pierce,1095,996,2091,527421
2020-08-31,WA,Lincoln,5,11,16,7625
2019-01-31,WA,Asotin,12,9,21,12729
2018-12-31,CA,Fresno,1,0,1,190
2022-04-30,WA,Clark,3,0,3,83236
2017-08-31,WA,Pierce,0,0,0,137231
2019-08-31,WA,Pend Oreille,5,6,11,9495
2022-05-31,WA,Adams,16,10,26,12957
2019-03-31,WA,Lewis,0,0,0,25755
2018-09-30,WA,King,7,1,8,182870
2023-05-31,WA,Kitsap,70,0,70,52120
2023-01-31,WA,Cowlitz,7,0,7,28344
2022-08-31,CA,Kings,2,1,3,290
2020-08-31,CA,San Diego,15,5,20,2745
2020-01-31,WA,Wahkiakum,4,5,9,3034
2019-07-31,WA,Columbia,0,0,0,1529
2022-01-31,WA,Yakima,294,177,471,168293
2018-11-30,WA,Chelan,135,60,195,54064
2019-02-28,WA,Pend Oreille,5,5,10,9483
2019-10-31,WA,Okanogan,24,28,52,26251
2019-10-31,WA,Adams,6,6,12,12912
2017-07-31,WA,Pend Oreille,0,0,0,5582
2023-05-31,WA,Spokane,39,0,39,101203
2022-06-30,WA,Thurston,2182,1055,3237,194425
2020-02-29,CA,San Mateo,0,1,1,116
2017-01-31,WA,Stevens,0,0,0,18341
2020-01-31,WA,Benton,337,315,652,135323
2017-10-31,WA,Cowlitz,54,65,119,70430
2019-07-31,WA,Garfield,1,1,2,1298
2018-08-31,WA,Cowlitz,62,81,143,71989
2017-01-31,WA,Clark,0,0,0,77522
2022-05-31,WA,Kitsap,2354,1031,3385,178653
2019-01-31,WA,Walla Walla,42,54,96,36138
2020-11-30,WA,Pacific,36,34,70,15737
2019-03-31,CA,Shasta,1,0,1,41
2021-12-31,WA,Clallam,383,239,622,50384
2017-12-31,WA,Clallam,99,91,190,49056
2017-08-31,WA,Clark,794,528,1322,300774
2018-09-30,WA,Jefferson,153,99,252,24693
2021-12-31,WA,Klickitat,89,53,142,15347
2021-09-30,WA,Douglas,103,51,154,28572
2018-01-31,WA,Lewis,52,43,95,56805
2018-05-31,CA,Santa Clara,7,0,7,381
2019-06-30,WA,Kittitas,0,0,0,14422
2021-06-30,CA,Kern,0,1,1,211
2018-10-31,WA,Cowlitz,69,86,155,72155
2021-08-31,WA,Wahkiakum,0,0,0,1801
2019-03-31,WA,King,6,1,7,181762
2019-12-31,WA,Clark,0,0,0,81316
2019-03-31,WA,Clark,1358,881,2239,311974
2017-11-30,WA,King,11131,4614,15745,1371535
2017-03-31,WA,Clallam,0,0,0,21041
2017-07-31,CA,Tulare,1,0,1,195
2022-11-30,CA,Santa Cruz,1,0,1,18
2017-07-31,WA,Grant,19,30,49,61004
2022-11-30,WA,Ferry,24,4,28,4370
2022-03-31,WA,Adams,0,0,0,5488
2021-04-30,WA,Lewis,0,0,0,26910
2017-09-30,WA,Walla Walla,27,28,55,35036
2020-10-31,CA,Monterey,0,1,1,155
2020-04-30,WA,Whitman,44,48,92,22313
2020-09-30,WA,Asotin,17,14,31,12398
2022-03-31,WA,Thurston,3,0,3,55747
2023-04-30,CA,San Bernardino,2,1,3,253
2019-06-30,WA,Pend Oreille,0,0,0,5732
2018-08-31,WA,Clark,0,0,0,79303
2018-07-31,WA,Wahkiakum,0,0,0,1681
2020-11-30,WA,Spokane,859,542,1401,320275
2023-05-31,WA,Stevens,110,64,174,29562
2023-05-31,CA,Kings,2,1,3,255
2019-07-31,WA,Yakima,109,107,216,165397
2017-03-31,CA,San Mateo,0,1,1,157
2020-04-30,CA,Ventura,0,3,3,287
2021-09-30,WA,Chelan,0,0,0,23103
2022-10-31,CA,Monterey,1,1,2,120
2019-11-30,WA,Ferry,5,2,7,4414
2021-02-28,WA,Pacific,37,38,75,15822
2023-02-28,WA,Adams,21,11,32,13008
2018-04-30,CA,Ventura,0,1,1,319
2018-10-31,WA,Walla Walla,36,50,86,35994
2023-05-31,WA,San Juan,611,173,784,13720
2020-07-31,WA,Lincoln,0,0,0,4661
2018-06-30,WA,Snohomish,1,0,1,121653
2019-04-30,WA,Yakima,0,0,0,58948
2022-12-31,WA,Adams,23,11,34,13019
2021-12-31,WA,Wahkiakum,0,0,0,1824
2021-06-30,WA,Ferry,9,3,12,4373
2017-07-31,WA,Jefferson,0,0,0,9414
2017-01-31,WA,Clark,673,426,1099,297819
2019-12-31,WA,Garfield,0,1,1,1306
2022-08-31,WA,Asotin,0,0,0,6695
2017-06-30,WA,Pacific,0,0,0,7471
2018-12-31,WA,Grant,32,52,84,64196
2019-04-30,WA,Skamania,21,16,37,8713
2021-06-30,WA,Franklin,123,97,220,62016
2019-07-31,WA,San Juan,220,72,292,14446
2022-06-30,WA,Walla Walla,0,0,0,13934
2022-11-30,WA,Benton,7,0,7,43416
2019-07-31,WA,Lewis,0,0,0,25966
2018-11-30,WA,Spokane,408,358,766,306895
2022-02-28,WA,Grays Harbor,0,0,0,21340
2021-08-31,WA,Cowlitz,237,152,389,72118
2020-01-31,WA,Pend Oreille,8,7,15,9470
2022-12-31,WA,Walla Walla,201,106,307,35691
2022-06-30,WA,Whatcom,7,0,7,43365
2022-03-31,WA,Clark,3744,1656,5400,318350
2020-01-31,WA,King,23196,7620,30816,1399178
2020-11-30,WA,Stevens,36,39,75,30275
2022-01-31,WA,Skamania,60,43,103,8316
2018-04-30,WA,Snohomish,1,0,1,121256
2019-05-31,WA,Wahkiakum,2,2,4,3017
2020-08-31,CA,Santa Clara,8,2,10,274
2018-05-31,WA,Clark,963,696,1659,307153
2022-09-30,WA,Stevens,81,56,137,30090
2021-11-30,WA,Skamania,57,40,97,8344
2019-11-30,WA,San Juan,0,0,0,5929
2022-10-31,WA,Kittitas,291,94,385,29590
2019-09-30,WA,Pacific,25,29,54,16078
2020-08-31,WA,Cowlitz,152,120,272,72131
2019-05-31,WA,Skamania,23,17,40,8719
2021-09-30,WA,Wahkiakum,16,8,24,3071
2020-04-30,WA,Asotin,0,0,0,6617
2018-09-30,WA,Walla Walla,36,50,86,35925
2021-07-31,WA,Chelan,350,101,451,54716
2017-06-30,WA,Wahkiakum,0,2,2,2832
2020-03-31,WA,Whatcom,3,0,3,43025
2020-08-31,WA,Lincoln,0,0,0,4652
2022-09-30,WA,Pierce,5530,2431,7961,541956
2021-04-30,WA,Kittitas,153,58,211,29983
2023-02-28,WA,Garfield,0,0,0,979
2021-11-30,WA,San Juan,473,147,620,14195
2021-04-30,WA,Whatcom,1355,582,1937,151158
2018-02-28,WA,Franklin,32,51,83,57008
2021-12-31,WA,Franklin,162,104,266,62306
2022-06-30,WA,Garfield,0,0,0,984
2017-10-31,WA,Whitman,12,20,32,22299
2020-03-31,CA,Placer,2,0,2,92
2017-02-28,WA,Lincoln,2,4,6,7509
2023-03-31,WA,Clallam,17,0,17,21712
2021-11-30,WA,Klickitat,0,0,0,8335
2020-06-30,WA,Ferry,5,3,8,4330
2019-11-30,WA,Benton,0,0,0,42413
2022-12-31,CA,San Bernardino,1,1,2,282
2019-11-30,WA,Asotin,0,0,0,6694
2017-05-31,WA,Thurston,0,0,0,53243
2021-01-31,WA,Cowlitz,188,129,317,72162
2017-01-31,WA,Chelan,54,28,82,51898
2019-04-30,CA,San Joaquin,1,0,1,133
2020-12-31,WA,Mason,0,0,0,20948
2021-08-31,WA,Klickitat,0,0,0,8331
2018-09-30,WA,Jefferson,0,0,0,9644
2018-08-31,WA,Skagit,1,0,1,32229
2019-10-31,WA,Grant,0,0,0,26891
2019-03-31,WA,Garfield,1,1,2,1310
2018-11-30,WA,Clallam,0,0,0,21613
2019-02-28,WA,Asotin,12,9,21,12682
2021-03-31,WA,Island,0,0,0,21460
2023-03-31,CA,Kern,1,1,2,178
2021-07-31,WA,Stevens,0,0,0,18921
2018-07-31,WA,Klickitat,0,0,0,8126
2021-01-31,WA,Garfield,0,0,0,1003
2020-05-31,CA,San Mateo,0,1,1,113
2022-01-31,WA,Jefferson,385,197,582,24693
2021-10-31,WA,Pacific,0,0,0,7990
2021-11-30,WA,Yakima,0,0,0,61715
2021-09-30,WA,Pierce,0,0,0,145459
2020-04-30,WA,Columbia,0,0,0,1524
2020-10-31,WA,Clark,0,0,0,83170
2022-07-31,WA,Columbia,0,0,0,1577
2021-12-31,WA,Pacific,51,64,115,16068
2020-03-31,CA,Shasta,1,0,1,38
2020-10-31,WA,Island,463,284,747,62908
2022-08-31,WA,Kittitas,284,88,372,29610
2022-10-31,WA,Garfield,1,3,4,1315
2017-11-30,WA,Douglas,37,33,70,27072
2022-02-28,WA,Spokane,1392,784,2176,326237
2018-11-30,WA,Skamania,18,14,32,8731
2023-01-31,WA,Wahkiakum,1,0,1,1794
2019-05-31,WA,Thurston,0,0,0,55085
2020-09-30,WA,Walla Walla,86,62,148,35944
2017-12-31,WA,Columbia,2,1,3,2403
2022-01-31,WA,Walla Walla,0,0,0,14104
2018-04-30,WA,Yakima,62,84,146,163240
2020-05-31,WA,Kittitas,102,48,150,29778
2020-04-30,CA,Shasta,1,0,1,37
2020-05-31,WA,Franklin,58,75,133,60574
2023-02-28,WA,Whitman,124,71,195,22018
2017-03-31,WA,Cowlitz,0,0,0,27906
2020-11-30,WA,Garfield,0,0,0,997
2023-07-31,WA,Okanogan,128,62,190,25306
2021-11-30,WA,Yakima,272,167,439,168647
2021-10-31,WA,Yakima,270,165,435,168835
2018-12-31,WA,Cowlitz,0,0,0,28739
2022-07-31,CA,Monterey,1,1,2,124
2018-06-30,WA,Franklin,0,0,0,18663
2021-04-30,WA,Asotin,0,0,0,6769
2018-06-30,WA,Ferry,3,3,6,4425
2022-06-30,WA,Mason,311,177,488,47350
2020-06-30,WA,Grant,0,0,0,27083
2019-12-31,WA,Thurston,1052,701,1753,199236
2017-06-30,WA,Kittitas,0,0,0,13560
2020-08-31,WA,Whatcom,1111,512,1623,149201
2021-09-30,WA,Thurston,1751,908,2659,197543
2023-06-30,WA,Ferry,0,0,0,3530
2023-04-30,WA,Walla Walla,5,0,5,13674
2020-03-31,WA,Ferry,5,3,8,4365
2020-12-31,WA,Clark,2356,1180,3536,319513
2022-07-31,WA,Walla Walla,175,99,274,35828
2023-03-31,WA,Island,987,421,1408,61377
2021-12-31,WA,Clark,1,0,1,83996
2017-12-31,WA,Garfield,0,0,0,943
2021-02-28,WA,Okanogan,56,35,91,26131
2018-02-28,WA,Pend Oreille,0,0,0,5631
2022-02-28,CA,Los Angeles,10,7,17,809
2021-01-31,WA,Okanogan,0,0,0,16594
2019-07-31,WA,Skamania,25,18,43,8739
2017-08-31,WA,Skamania,0,0,0,3876
2018-11-30,WA,King,15784,6398,22182,1377200
2017-08-31,WA,Whitman,0,0,0,8451
2020-09-30,WA,Grant,67,80,147,65582
2019-09-30,WA,Thurston,0,0,0,55538
2019-10-31,WA,Pierce,2058,1629,3687,546972
2019-05-31,WA,Grant,0,0,0,26531
2017-03-31,CA,Los Angeles,3,1,4,1365
2020-08-31,WA,Whatcom,3,0,3,43278
2018-03-31,WA,Columbia,0,0,0,1532
2022-04-30,WA,King,26,1,27,181794
2017-04-30,WA,Kitsap,1,0,1,52312
2018-07-31,WA,Jefferson,147,99,246,24581
2021-06-30,CA,Riverside,5,1,6,544
2017-11-30,WA,Island,0,0,0,20694
2023-06-30,WA,Clallam,20,0,20,21479
2021-03-31,WA,Grant,0,0,0,27760
2019-12-31,WA,Okanogan,0,0,0,16550
2019-08-31,WA,Thurston,927,661,1588,198371
2017-07-31,WA,Douglas,35,26,61,26756
2018-08-31,CA,Orange,4,1,5,553
2021-08-31,WA,Whatcom,4,0,4,43867
2023-06-30,CA,Solano,5,0,5,129
2020-08-31,WA,Adams,0,0,0,5303
2017-12-31,WA,Kitsap,1,0,1,52687
2017-11-30,WA,Wahkiakum,0,0,0,1661
2021-08-31,WA,King,5,1,6,184053
2022-12-31,CA,Santa Cruz,1,0,1,15
2021-05-31,CA,El Dorado,1,0,1,29
2018-08-31,WA,Spokane,360,336,696,304743
2021-03-31,WA,Kitsap,0,0,0,54392
2019-03-31,WA,Whatcom,2,0,2,42724
2020-02-29,CA,Orange,7,2,9,502
2017-02-28,WA,Island,0,0,0,20499
2018-05-31,WA,Cowlitz,0,0,0,28359
2017-10-31,CA,Riverside,1,2,3,744
2022-09-30,WA,Yakima,376,210,586,166551
2018-11-30,WA,Adams,5,5,10,12749
2020-10-31,WA,Whatcom,3,0,3,43462
2021-01-31,WA,Jefferson,0,0,0,9597
2019-07-31,WA,Pierce,0,0,0,140021
2018-06-30,WA,Stevens,11,25,36,31637
2020-10-31,WA,Kitsap,0,0,0,54236
2019-02-28,WA,Lincoln,0,0,0,4667
2021-06-30,WA,Cowlitz,224,142,366,72350
2022-12-31,WA,Pierce,82,0,82,139604
2023-06-30,CA,Los Angeles,4,4,8,540
2020-03-31,WA,Island,406,269,675,63248
2017-10-31,WA,Pierce,1040,916,1956,525482
2018-09-30,WA,Adams,0,0,0,5158
2022-04-30,CA,Ventura,2,1,3,231
2020-02-29,WA,Clark,1970,1058,3028,320541
2022-02-28,WA,Clark,3627,1600,5227,319148
2017-05-31,WA,Franklin,28,44,72,55459
2022-10-31,CA,Contra Costa,0,3,3,214
2020-11-30,WA,Thurston,1290,763,2053,197232
2021-10-31,WA,Pierce,4001,2085,6086,557924
2018-11-30,WA,Yakima,0,0,0,58751
2019-07-31,WA,Cowlitz,106,107,213,73140
2018-11-30,WA,Snohomish,2789,1415,4204,526785
2019-06-30,WA,Spokane,539,433,972,311797
2019-07-31,WA,Thurston,905,652,1557,198166
2018-05-31,WA,Snohomish,1,0,1,121479
2017-06-30,WA,Stevens,8,23,31,31384
2022-09-30,WA,Douglas,147,61,208,28445
2019-12-31,WA,Chelan,201,78,279,54622
2019-12-31,WA,Whatcom,2,0,2,43188
2023-06-30,CA,Santa Cruz,1,0,1,12
2023-05-31,WA,Asotin,34,20,54,12351
2017-03-31,WA,Ferry,2,1,3,4386
2017-06-30,WA,Skamania,0,0,0,3892
2022-05-31,WA,Pacific,60,68,128,15915
2020-04-30,WA,Kitsap,1,0,1,53907
2021-09-30,CA,San Luis Obispo,1,0,1,59
2022-11-30,CA,Sonoma,1,1,2,64
2021-11-30,WA,Island,701,342,1043,62971
2018-06-30,WA,Pacific,17,20,37,15572
2017-01-31,WA,Pend Oreille,1,4,5,9345
2020-01-31,WA,Island,1,0,1,21354
2021-05-31,CA,San Francisco,1,1,2,87
2021-03-31,WA,Jefferson,0,0,0,9591
2020-05-31,WA,Skamania,0,0,0,4029
2022-07-31,WA,Stevens,1,0,1,18912
2018-07-31,WA,Grays Harbor,54,62,116,46760
2017-09-30,WA,Benton,163,150,313,129262
2023-01-31,WA,King,461,2,463,177951
2023-06-30,WA,Yakima,501,257,758,163736
2020-11-30,WA,Jefferson,276,153,429,24728
2021-03-31,CA,Santa Cruz,1,0,1,29
2018-05-31,WA,Grays Harbor,50,55,105,46409
2021-10-31,WA,Columbia,7,2,9,2439
2020-11-30,WA,Columbia,0,0,0,1530
2020-04-30,WA,Wahkiakum,6,5,11,2973
2021-03-31,WA,King,28522,8567,37089,1365152
2020-12-31,WA,Wahkiakum,6,7,13,3036
2017-12-31,WA,Klickitat,0,0,0,8003
2022-06-30,CA,Sacramento,3,0,3,187
2019-02-28,WA,Jefferson,179,113,292,24863
2019-01-31,WA,Snohomish,3075,1488,4563,528288
2017-03-31,CA,Orange,2,1,3,659
2021-05-31,WA,Chelan,322,98,420,54729
2019-08-31,WA,Lincoln,0,0,0,4683
2020-09-30,WA,Whatcom,1140,525,1665,149401
2017-07-31,WA,Grays Harbor,0,0,0,19894
2019-04-30,WA,Okanogan,20,22,42,26020
2017-07-31,WA,Asotin,8,4,12,12439
2020-06-30,WA,Mason,159,135,294,47272
2018-05-31,WA,Island,0,0,0,20885
2019-05-31,WA,Kittitas,72,35,107,29555
2020-11-30,WA,Kittitas,0,0,0,14645
2023-01-31,WA,Stevens,96,57,153,29986
2019-09-30,WA,Chelan,174,71,245,54511
2018-03-31,WA,Kittitas,40,30,70,28748
2018-04-30,WA,Skamania,12,8,20,8705
2022-08-31,WA,Columbia,0,0,0,1574
2022-02-28,WA,Garfield,0,3,3,1353
2022-01-31,CA,Orange,5,2,7,379
2019-01-31,WA,Clallam,0,0,0,21632
2018-08-31,WA,Walla Walla,0,0,0,13497
2023-04-30,CA,Kern,1,1,2,171
2020-05-31,WA,Whatcom,3,0,3,42847
2018-03-31,WA,Clark,0,0,0,78628
2019-07-31,CA,San Mateo,2,1,3,117
2022-06-30,CA,Riverside,8,1,9,449
2021-10-31,WA,Clark,0,0,0,84034
2022-06-30,WA,Benton,3,0,3,43576
2019-09-30,CA,Tuolumne,0,1,1,11
2019-03-31,WA,Stevens,18,27,45,31632
2021-06-30,WA,Island,617,317,934,63262
2022-04-30,CA,Sonoma,0,1,1,72
2018-09-30,WA,Mason,94,100,194,46187
2023-05-31,WA,Whitman,4,0,4,8547
2019-03-31,CA,Santa Cruz,1,0,1,41
2021-03-31,WA,Snohomish,5384,1931,7315,538886
2021-08-31,WA,Whitman,63,52,115,21930
2021-02-28,WA,Walla Walla,0,0,0,13907
2023-04-30,WA,Klickitat,8,0,8,8230
2021-01-31,CA,Placer,2,0,2,81
2021-08-31,CA,Santa Cruz,1,0,1,25
2021-02-28,WA,Grays Harbor,142,130,272,48797
2018-07-31,WA,Yakima,65,93,158,163968
2019-12-31,WA,Ferry,5,2,7,4398
2017-07-31,WA,Garfield,0,0,0,926
2019-11-30,CA,Ventura,0,3,3,302
2018-04-30,WA,Chelan,98,45,143,53398
2022-09-30,WA,Whatcom,14,0,14,43119
2020-06-30,CA,Monterey,0,1,1,163
2020-12-31,WA,Garfield,0,2,2,1367
2021-07-31,WA,Whitman,0,0,0,8590
2020-12-31,WA,Yakima,170,128,298,167294
2019-09-30,WA,Snohomish,3740,1661,5401,533934
2017-07-31,CA,San Diego,6,1,7,2699
2018-03-31,WA,Garfield,0,0,0,952
2018-11-30,WA,Clallam,147,121,268,50323
2019-10-31,WA,Grays Harbor,0,0,0,20730
2022-07-31,CA,San Mateo,2,0,2,75
2018-11-30,WA,Columbia,0,0,0,1516
2018-06-30,WA,Columbia,2,2,4,2424
2021-12-31,WA,King,35480,10222,45702,1359266
2020-03-31,WA,Grant,58,71,129,65493
2022-09-30,CA,Kings,2,1,3,286
2022-05-31,CA,Sonoma,0,1,1,74
2021-09-30,CA,San Joaquin,1,1,2,97
2022-01-31,CA,San Francisco,0,1,1,77
2017-01-31,WA,Lincoln,0,0,0,4462
2023-06-30,WA,Franklin,5,0,5,20588
2019-04-30,WA,Garfield,0,0,0,958
2021-04-30,WA,Thurston,1494,834,2328,198087
2019-08-31,CA,San Diego,10,3,13,2757
2019-11-30,WA,Okanogan,27,30,57,26234
2023-02-28,WA,San Juan,10,0,10,5886
2021-12-31,WA,Grays Harbor,0,0,0,21388
2019-11-30,WA,Kitsap,1190,649,1839,182242
2020-06-30,CA,Riverside,3,1,4,619
2017-04-30,WA,Garfield,0,0,0,938
2020-02-29,CA,Fresno,1,0,1,188
2020-08-31,WA,Pierce,0,0,0,143398
2022-01-31,WA,Island,734,344,1078,62598
2020-10-31,WA,San Juan,340,103,443,13969
2017-12-31,WA,Snohomish,2016,1051,3067,516915
2019-07-31,WA,Skagit,1,0,1,32524
2017-03-31,WA,Kitsap,572,289,861,172480
2018-04-30,WA,Skagit,182,155,337,90035
2018-03-31,WA,Asotin,8,5,13,12627
2019-05-31,WA,Island,0,0,0,21242
2018-07-31,WA,Skamania,0,0,0,3960
2021-11-30,CA,San Mateo,2,0,2,79
2020-06-30,WA,Skamania,0,0,0,4011
2021-10-31,WA,Pend Oreille,18,7,25,9206
2022-03-31,WA,Mason,286,171,457,47633
2020-08-31,WA,San Juan,320,100,420,13928
2020-11-30,WA,Okanogan,51,37,88,25984
2021-07-31,CA,Kings,1,0,1,319
2017-10-31,WA,Clallam,0,0,0,21147
2019-08-31,WA,Lewis,0,0,0,25986
2018-12-31,WA,Klickitat,28,32,60,15431
2018-04-30,WA,Wahkiakum,1,3,4,2887
2021-08-31,WA,San Juan,0,0,0,5976
2022-07-31,WA,Lewis,0,0,0,26347
2019-05-31,CA,Alameda,3,2,5,308
2018-12-31,WA,Franklin,45,66,111,59124
2019-04-30,WA,Clark,1414,896,2310,312581
2019-03-31,WA,Snohomish,1,0,1,121910
2017-05-31,WA,Clark,0,0,0,77598
2017-10-31,WA,Clark,829,559,1388,302262
2020-03-31,CA,Fresno,1,0,1,187
2022-05-31,WA,King,43,1,44,181226
2022-05-31,WA,Spokane,1543,832,2375,325374
2022-08-31,WA,Benton,815,471,1286,135382
2020-11-30,CA,San Mateo,1,1,2,108
2019-01-31,WA,Kittitas,69,36,105,29465
2019-10-31,CA,Solano,1,0,1,205
2023-01-31,WA,Lewis,281,185,466,59747
2017-11-30,WA,Benton,0,0,0,40497
2018-10-31,CA,Los Angeles,6,5,11,1134
2020-12-31,CA,Santa Cruz,1,0,1,27
2022-06-30,WA,Spokane,1,0,1,102259
2017-07-31,WA,Lincoln,0,0,0,4445
2020-01-31,WA,Mason,150,135,285,47624
2021-11-30,WA,Grant,131,97,228,66942
2017-07-31,WA,Clark,795,517,1312,299957
2022-10-31,CA,Santa Clara,9,2,11,184
2019-11-30,WA,Franklin,53,75,128,60785
2019-04-30,CA,San Diego,10,3,13,2654
2019-04-30,WA,Cowlitz,0,0,0,28852
2019-04-30,CA,Ventura,0,2,2,311
2022-02-28,WA,Lincoln,0,0,0,4845
2022-01-31,WA,Kitsap,0,0,0,54155
2017-02-28,WA,Cowlitz,0,0,0,27871
2018-05-31,WA,Columbia,2,1,3,2412
2019-07-31,CA,Los Angeles,8,5,13,1110
2022-07-31,CA,Los Angeles,8,8,16,730
2021-12-31,WA,Yakima,0,0,0,61785
2019-04-30,CA,Kern,0,1,1,225
2022-08-31,WA,Kitsap,2523,1093,3616,177977
2019-05-31,WA,Benton,253,272,525,133636
2018-09-30,WA,Kittitas,0,0,0,14105
2023-07-31,WA,Snohomish,187,0,187,117767
2017-09-30,WA,Pacific,12,9,21,15262
2018-02-28,WA,Lincoln,2,5,7,7594
2021-09-30,WA,Kitsap,0,0,0,54327
2023-05-31,WA,Snohomish,12139,2974,15113,524703
2017-09-30,WA,Skagit,148,120,268,88642
2021-06-30,WA,Kitsap,0,0,0,54475
2017-11-30,WA,Lewis,0,0,0,25234
2023-02-28,WA,Wahkiakum,1,0,1,1793
2018-02-28,CA,Sacramento,1,0,1,297
2022-02-28,WA,Kitsap,2230,982,3212,179653
2018-11-30,WA,Lewis,89,71,160,58211
2023-04-30,WA,Jefferson,10,0,10,9292
2023-04-30,WA,Thurston,55,0,55,53886
2018-02-28,CA,Santa Clara,7,1,8,380
2020-04-30,WA,Benton,348,321,669,134556
2022-03-31,WA,Douglas,0,0,0,12726
2020-12-31,WA,Kittitas,0,0,0,14646
2022-07-31,WA,Jefferson,442,219,661,24548
2020-10-31,CA,Contra Costa,4,3,7,286
2019-03-31,WA,Skagit,1,0,1,32255
2019-02-28,CA,San Francisco,2,1,3,114
2021-10-31,WA,Snohomish,6655,2197,8852,538791
2022-06-30,WA,Douglas,0,0,0,12790
2020-06-30,WA,Kitsap,0,0,0,54064
2022-10-31,WA,Jefferson,464,225,689,24416
2018-08-31,CA,San Mateo,1,1,2,133
2017-11-30,CA,Riverside,1,2,3,748
2020-08-31,WA,Franklin,0,0,0,20187
2019-05-31,WA,Chelan,0,0,0,22243
2017-07-31,WA,San Juan,0,0,0,5547
2022-06-30,CA,San Luis Obispo,1,0,1,53
2020-07-31,WA,Grays Harbor,109,112,221,48286
2018-12-31,WA,Grays Harbor,0,0,0,20356
2022-01-31,WA,Benton,654,453,1107,135958
2019-10-31,WA,Clallam,1,0,1,21846
2017-11-30,WA,Thurston,0,0,0,53689
2017-01-31,WA,Skamania,7,7,14,8549
2019-03-31,WA,Pacific,23,26,49,15850
2018-08-31,CA,Riverside,2,2,4,692
2017-07-31,WA,Lewis,0,0,0,24914
2021-05-31,WA,Asotin,19,14,33,12700
2018-05-31,CA,Riverside,2,2,4,703
2020-11-30,WA,Asotin,17,14,31,12411
2022-07-31,WA,Kitsap,13,0,13,53416
2022-01-31,WA,Thurston,3,0,3,55934
2020-01-31,WA,Douglas,69,39,108,28367
2017-10-31,CA,Los Angeles,5,2,7,1219
2018-02-28,CA,Marin,1,0,1,56
2019-08-31,WA,Okanogan,0,0,0,16479
2020-09-30,WA,Kittitas,113,48,161,29701
2017-04-30,WA,Lewis,0,0,0,24797
2017-08-31,WA,Jefferson,112,64,176,23954
2020-03-31,WA,Lewis,0,0,0,26030
2020-10-31,WA,King,25876,8012,33888,1372970
2017-08-31,WA,Pend Oreille,3,4,7,9358
2018-10-31,CA,Santa Cruz,1,0,1,40
2021-05-31,WA,Cowlitz,218,136,354,72447
2018-12-31,WA,Kittitas,66,37,103,29339
2021-12-31,WA,Lincoln,7,16,23,7719
2021-07-31,WA,Stevens,49,46,95,30404
2022-09-30,WA,Grant,2,0,2,28018
2022-04-30,WA,Columbia,7,0,7,2446
2017-05-31,WA,Benton,146,142,288,128293
2022-12-31,WA,Spokane,20,0,20,101929
2018-08-31,WA,Pierce,0,0,0,138304
2019-12-31,CA,Santa Cruz,1,0,1,36
2022-02-28,WA,Benton,0,0,0,43644
2017-11-30,WA,Klickitat,23,26,49,14871
2021-05-31,WA,Klickitat,66,47,113,15237
2022-08-31,WA,Douglas,1,0,1,12758
2020-03-31,WA,Spokane,704,473,1177,317986
2020-02-29,WA,Cowlitz,128,111,239,73460
2020-12-31,WA,Thurston,0,0,0,56389
2023-02-28,WA,Douglas,6,0,6,12882
2021-08-31,WA,Garfield,0,3,3,1369
2021-05-31,WA,Skagit,577,265,842,91964
2019-05-31,WA,Benton,0,0,0,41850
2021-02-28,WA,Douglas,86,46,132,28249
2020-08-31,WA,Columbia,3,3,6,2423
2017-04-30,WA,Asotin,6,2,8,12343
2018-03-31,WA,Clallam,0,0,0,21314
2019-01-31,CA,Alameda,0,2,2,316
2018-07-31,WA,Clark,1042,744,1786,308652
2022-02-28,WA,Clallam,1,0,1,22104
2022-07-31,WA,Walla Walla,1,0,1,13918
2019-01-31,WA,Clark,0,0,0,79967
2021-09-30,WA,Columbia,0,0,0,1537
2021-10-31,WA,King,33841,9915,43756,1363940
2023-07-31,WA,Clallam,563,289,852,47919
2017-12-31,CA,Sacramento,1,0,1,311
2020-03-31,WA,Kitsap,1297,674,1971,181797
2019-02-28,WA,Skamania,20,15,35,8715
2021-05-31,WA,Walla Walla,110,72,182,36556
2017-02-28,WA,Spokane,226,196,422,295023
2021-09-30,WA,Thurston,0,0,0,56349
2022-11-30,WA,Pierce,5996,2477,8473,540119
2023-05-31,WA,Mason,429,206,635,45953
2021-11-30,WA,Columbia,6,2,8,2459
2018-12-31,WA,Skagit,1,0,1,32318
2020-05-31,WA,San Juan,298,91,389,14062
2021-12-31,WA,Klickitat,0,0,0,8333
2017-12-31,WA,Pacific,0,0,0,7545
2021-12-31,WA,Island,0,0,0,21524
2019-06-30,WA,Adams,5,6,11,12757
2021-02-28,CA,Riverside,4,1,5,581
2018-10-31,WA,Mason,0,0,0,20174
2021-08-31,WA,Snohomish,1,0,1,126015
2020-06-30,WA,Kittitas,99,47,146,29805
2017-09-30,WA,Kitsap,1,0,1,52599
2017-12-31,WA,Whatcom,532,227,759,145194
2017-06-30,WA,Grays Harbor,0,0,0,19888
2019-01-31,WA,Whitman,24,40,64,22845
2021-10-31,WA,Jefferson,362,191,553,24778
2020-06-30,WA,Lincoln,5,12,17,7624
2023-01-31,WA,Asotin,30,20,50,12490
2017-08-31,WA,Franklin,27,48,75,55929
2020-02-29,WA,Asotin,0,0,0,6695
2019-01-31,WA,Pend Oreille,0,0,0,5743
2022-08-31,WA,Jefferson,453,223,676,24508
2020-12-31,WA,San Juan,365,111,476,14021
2017-07-31,WA,Skagit,141,104,245,88182
2023-07-31,CA,Orange,6,2,8,246
2021-02-28,CA,Sacramento,2,0,2,232
2023-02-28,WA,Lincoln,0,0,0,4846
2017-10-31,WA,Asotin,7,5,12,12479
2019-12-31,WA,King,6,1,7,182216
2023-03-31,WA,Stevens,2,0,2,18741
2021-11-30,WA,Skagit,1,0,1,32804
2019-08-31,WA,Asotin,0,0,0,6684
2021-02-28,WA,Okanogan,0,0,0,16631
2022-09-30,WA,Spokane,1770,889,2659,324764
2022-08-31,WA,Spokane,1743,881,2624,324740
2019-06-30,WA,King,19080,7013,26093,1389199
2017-01-31,WA,Mason,48,60,108,42807
2019-03-31,CA,San Diego,10,3,13,2649
2017-11-30,WA,Whatcom,1,0,1,41929
2019-11-30,WA,Chelan,196,75,271,54642
2017-05-31,WA,Asotin,6,3,9,12376
2017-12-31,WA,Clark,0,0,0,78388
2022-09-30,WA,Island,10,0,10,21293
2019-01-31,WA,Clallam,152,128,280,50402
2017-01-31,WA,Lincoln,2,4,6,7543
2021-11-30,WA,Kitsap,2083,941,3024,180487
2018-02-28,WA,Skagit,172,145,317,89751
2018-02-28,WA,Thurston,492,414,906,190758
2018-03-31,WA,Columbia,2,1,3,2409
2022-08-31,WA,Jefferson,3,0,3,9424
2021-10-31,CA,Placer,2,0,2,71
2019-06-30,WA,Adams,0,0,0,5128
2021-03-31,WA,Walla Walla,0,0,0,13966
2018-10-31,CA,Shasta,1,0,1,43
2023-04-30,WA,Douglas,7,0,7,12882
2022-02-28,WA,Lewis,0,0,0,26607
2022-05-31,CA,Santa Clara,10,1,11,216
2022-12-31,WA,Spokane,1943,932,2875,324633
2019-10-31,WA,Clallam,194,150,344,50936
2019-06-30,WA,Klickitat,0,0,0,8251
2021-12-31,CA,Ventura,2,1,3,242
2018-05-31,WA,Clark,0,0,0,78917
2019-06-30,CA,San Diego,10,3,13,2686
2020-04-30,WA,Spokane,711,473,1184,316298
2022-09-30,CA,Solano,2,0,2,151
2021-09-30,WA,Snohomish,1,0,1,125958
2019-01-31,WA,Klickitat,0,0,0,8228
2019-10-31,WA,Lincoln,2,11,13,7831
2019-08-31,WA,Snohomish,0,0,0,122863
2017-08-31,WA,Chelan,0,0,0,21363
2023-01-31,WA,Douglas,172,58,230,28592
2018-11-30,WA,Kitsap,1,0,1,53652
2021-02-28,WA,Stevens,0,0,0,18720
2022-11-30,WA,Garfield,0,0,0,981
2019-03-31,WA,Chelan,0,0,0,22127
2018-07-31,WA,Lincoln,3,6,9,7748
2023-05-31,WA,Chelan,619,159,778,53890
2017-05-31,WA,Stevens,0,0,0,18254
2018-03-31,WA,Whatcom,574,260,834,146117
2018-05-31,WA,Walla Walla,34,42,76,35569
2021-04-30,CA,San Mateo,1,1,2,102
2021-02-28,CA,El Dorado,1,0,1,32
2021-12-31,WA,San Juan,478,149,627,14189
2017-10-31,CA,Sacramento,1,0,1,323
2017-11-30,WA,Yakima,0,0,0,57917
2021-05-31,WA,Clark,0,0,0,84190
2017-06-30,WA,Okanogan,0,0,0,16204
2018-03-31,CA,Alameda,0,1,1,353
2021-03-31,WA,Skamania,0,0,0,4027
2021-11-30,WA,Columbia,0,0,0,1552
2021-10-31,WA,Klickitat,0,0,0,8316
2022-09-30,WA,Asotin,25,19,44,12615
2018-11-30,WA,Douglas,49,33,82,27967
2018-10-31,WA,Jefferson,0,0,0,9612
2022-08-31,CA,Solano,2,0,2,151
2017-03-31,WA,Spokane,232,202,434,295454
2017-01-31,WA,Clallam,0,0,0,21044
2018-04-30,WA,Asotin,0,0,0,6594
2022-11-30,WA,Stevens,88,56,144,30077
2023-01-31,WA,Kittitas,5,0,5,14551
2023-02-28,WA,Klickitat,127,57,184,15144
2019-03-31,WA,Benton,0,0,0,41532
2020-03-31,WA,Clallam,1,0,1,21817
2020-10-31,CA,Ventura,1,1,2,271
2022-04-30,WA,Yakima,0,0,0,61533
2019-10-31,WA,Thurston,1005,686,1691,199109
2019-12-31,CA,Placer,1,0,1,95
2019-03-31,WA,Thurston,802,598,1400,196182
2018-05-31,WA,Kitsap,780,453,1233,177900
2018-04-30,WA,Grays Harbor,0,0,0,20130
2023-06-30,WA,Pend Oreille,0,0,0,5519
2017-04-30,CA,Santa Clara,6,2,8,411
2019-06-30,CA,Shasta,1,0,1,42
2020-12-31,WA,Walla Walla,0,0,0,13871
2022-10-31,CA,Kings,2,1,3,284
2020-05-31,WA,Skagit,1,0,1,32389
2017-09-30,WA,Cowlitz,52,64,116,70272
2018-02-28,WA,Benton,175,179,354,130454
2018-06-30,WA,Douglas,0,0,0,11947
2019-02-28,WA,Wahkiakum,1,1,2,3020
2023-02-28,WA,Walla Walla,206,108,314,35642
2017-11-30,WA,Kitsap,676,367,1043,175388
2017-05-31,WA,Ferry,0,0,0,3544
2017-07-31,WA,Skamania,9,7,16,8552
2020-01-31,CA,Placer,1,0,1,93
2019-11-30,WA,Skagit,347,210,557,92574
2022-10-31,WA,San Juan,7,0,7,5952
2021-11-30,CA,Kings,2,0,2,322
2020-09-30,CA,San Joaquin,1,0,1,115
2023-02-28,CA,Alameda,3,0,3,152
2023-06-30,CA,Alameda,3,0,3,140
2017-07-31,CA,Tuolumne,0,1,1,14
2017-08-31,CA,Alameda,0,1,1,358
2020-08-31,CA,San Joaquin,1,0,1,121
2020-07-31,WA,Okanogan,0,0,0,16492
2022-10-31,WA,Skagit,8,0,8,32247
2022-10-31,WA,Franklin,239,112,351,61817
2017-06-30,WA,Lewis,0,0,0,24838
2019-09-30,WA,Spokane,1,0,1,95761
2021-07-31,WA,Mason,0,0,0,21344
2017-04-30,WA,Thurston,385,319,704,185729
2020-07-31,CA,Orange,7,2,9,482
2020-11-30,WA,Clark,2284,1140,3424,318828
2020-04-30,WA,Chelan,0,0,0,22460
2021-07-31,WA,Grant,120,90,210,66913
2020-07-31,CA,Alameda,2,0,2,264
2021-06-30,WA,Ferry,0,0,0,3641
2019-03-31,WA,Walla Walla,44,56,100,36067
2022-10-31,WA,San Juan,549,165,714,13992
2022-06-30,WA,Skamania,73,47,120,8213
2017-06-30,WA,Klickitat,0,0,0,7971
2022-06-30,WA,Wahkiakum,23,11,34,3072
2019-06-30,WA,Wahkiakum,2,2,4,3009
2018-11-30,WA,Spokane,1,0,1,93666
2022-01-31,WA,Mason,0,0,0,21187
2022-04-30,WA,Thurston,2073,1015,3088,195014
2017-09-30,CA,Sacramento,1,0,1,334
2017-02-28,WA,Jefferson,89,55,144,23601
2022-06-30,WA,Pend Oreille,17,11,28,9056
2019-03-31,CA,Alameda,3,2,5,317
2023-05-31,WA,Clark,90,0,90,80813
2021-12-31,WA,Snohomish,7024,2235,9259,537474
2022-07-31,CA,Alameda,4,0,4,177
2021-01-31,WA,Stevens,0,0,0,18751
2018-03-31,WA,Whitman,18,23,41,22489
2019-07-31,WA,Clark,1588,944,2532,314921
2023-04-30,WA,San Juan,12,0,12,5895
2023-02-28,WA,Chelan,19,0,19,23120
2022-07-31,WA,Snohomish,27,0,27,123535
2019-09-30,WA,Whatcom,922,460,1382,151337
2022-10-31,WA,Lincoln,0,0,0,4863
2021-11-30,WA,Jefferson,372,195,567,24790
2019-07-31,WA,Lincoln,0,0,0,4684
2018-09-30,WA,Grant,0,0,0,26068
2018-12-31,WA,Lincoln,0,0,0,4639
2022-04-30,WA,Pacific,0,0,0,7978
2018-09-30,WA,Clark,1089,784,1873,309720
2020-06-30,WA,Chelan,231,78,309,54185
2019-03-31,WA,Yakima,89,102,191,164203
2019-06-30,WA,Okanogan,22,25,47,26076
2022-12-31,WA,Pend Oreille,21,13,34,8969
2018-04-30,WA,Stevens,0,0,0,18512
2017-05-31,WA,Skagit,134,102,236,87854
2018-03-31,WA,Pend Oreille,0,0,0,5658
2022-08-31,WA,Adams,1,0,1,5434
2020-01-31,WA,Klickitat,48,39,87,15683
2022-06-30,WA,Wahkiakum,0,0,0,1804
2022-12-31,WA,Whatcom,2110,809,2919,148844
2022-08-31,CA,San Joaquin,1,1,2,80
2018-11-30,WA,Franklin,0,0,0,18987
2022-05-31,WA,San Juan,1,0,1,5979
2020-01-31,WA,Pacific,0,0,0,7748
2018-04-30,WA,Lewis,0,0,0,25310
2023-02-28,WA,Kittitas,6,0,6,14560
2021-05-31,CA,Contra Costa,3,3,6,267
2023-03-31,WA,Cowlitz,7,0,7,28202
2021-07-31,WA,Lewis,165,144,309,59658
2020-02-29,WA,Lincoln,1,12,13,7781
2018-06-30,CA,Orange,4,1,5,556
2019-03-31,WA,Pend Oreille,0,0,0,5721
2022-12-31,CA,Orange,7,2,9,301
2017-08-31,WA,Kitsap,1,0,1,52562
2019-09-30,WA,Columbia,0,0,0,1536
2020-08-31,WA,Grays Harbor,111,116,227,48357
2019-06-30,WA,Kitsap,1,0,1,54095
2023-01-31,CA,Contra Costa,0,3,3,203
2020-11-30,WA,Snohomish,4956,1823,6779,538061
2020-07-31,WA,Franklin,65,79,144,60778
2020-11-30,CA,Orange,4,3,7,451
2021-06-30,WA,Garfield,0,0,0,998
2022-02-28,CA,San Diego,14,8,22,2347
2021-06-30,WA,Whitman,0,0,0,8585
2017-10-31,WA,Benton,0,0,0,40386
2021-07-31,WA,Clark,0,0,0,84269
2017-08-31,CA,Riverside,1,2,3,769
2018-02-28,WA,Kitsap,716,418,1134,176380
2021-05-31,CA,Fresno,1,0,1,168
2021-08-31,WA,Clallam,1,0,1,22024
2021-06-30,CA,Contra Costa,2,3,5,261
2022-03-31,WA,Whitman,79,54,133,22044
2017-05-31,WA,Stevens,8,23,31,31329
2022-12-31,WA,Whatcom,26,0,26,43084
2018-03-31,WA,Klickitat,25,27,52,14973
2019-10-31,WA,Pacific,30,29,59,16110
2020-08-31,WA,Jefferson,0,0,0,9539
2018-04-30,WA,Snohomish,2189,1194,3383,518822
2023-05-31,WA,Pierce,7397,2707,10104,527950
2017-01-31,WA,Ferry,2,1,3,4386
2020-09-30,WA,Douglas,79,45,124,28040
2017-05-31,WA,Columbia,0,1,1,2359
2017-11-30,WA,Clallam,98,86,184,48866
2020-07-31,WA,Lewis,107,115,222,58138
2023-05-31,WA,Franklin,4,0,4,20695
2021-11-30,WA,Ferry,0,0,0,3600
2018-03-31,WA,Skamania,12,8,20,8667
2019-05-31,WA,Columbia,2,2,4,2443
2023-06-30,WA,Skamania,1,0,1,3776
2019-11-30,WA,Whitman,0,0,0,8581
2021-10-31,CA,Riverside,5,1,6,514
2018-08-31,WA,King,13801,5938,19739,1373749
2019-11-30,WA,Spokane,1,0,1,96217
2018-04-30,WA,Columbia,0,0,0,1523
2019-07-31,WA,Cowlitz,0,0,0,28867
2017-04-30,WA,Walla Walla,22,24,46,34828
2021-12-31,WA,Cowlitz,0,1,1,28998
2020-08-31,WA,Kittitas,110,47,157,29764
2017-02-28,WA,Clallam,75,64,139,47981
2023-07-31,WA,Asotin,35,23,58,12154
2019-06-30,CA,Riverside,2,2,4,655
2019-01-31,WA,Grays Harbor,0,0,0,20319
2019-12-31,WA,Lewis,0,0,0,26087
2019-02-28,WA,Cowlitz,0,0,0,28726
2020-05-31,WA,Stevens,0,0,0,18598
2021-11-30,CA,San Joaquin,1,1,2,95
2021-07-31,CA,Santa Cruz,1,0,1,24
2018-01-31,WA,Kitsap,1,0,1,52751
2022-03-31,WA,Pierce,4629,2234,6863,550172
2021-12-31,CA,Placer,2,0,2,71
2019-10-31,WA,Snohomish,0,0,0,123012
2017-09-30,WA,Columbia,1,1,2,2378
2023-03-31,WA,King,566,2,568,176388
2023-02-28,WA,Grays Harbor,2,0,2,21049
2022-09-30,WA,Jefferson,3,0,3,9383
2021-06-30,WA,Pierce,0,0,0,146075
2020-03-31,CA,Alameda,3,1,4,280
2023-04-30,WA,Cowlitz,433,203,636,69749
2019-03-31,WA,Walla Walla,0,0,0,13552
2017-09-30,WA,Okanogan,0,0,0,16235
2021-03-31,WA,Ferry,10,3,13,4349
2023-01-31,WA,Jefferson,6,0,6,9368
2017-08-31,WA,Grant,0,0,0,25352
2020-02-29,WA,Grays Harbor,0,0,0,20809
2018-05-31,WA,Lincoln,2,6,8,7644
2017-08-31,WA,Adams,3,3,6,12183
2022-05-31,WA,Kitsap,3,0,3,53699
2017-09-30,WA,Klickitat,22,26,48,14774
2022-07-31,CA,Placer,2,0,2,64
2018-06-30,WA,Kitsap,1,0,1,53204
2020-05-31,WA,Douglas,0,0,0,12279
2017-02-28,WA,Okanogan,0,0,0,16300
2019-09-30,WA,Ferry,0,0,0,3583
2020-01-31,WA,Skagit,378,215,593,92622
2023-05-31,WA,Whatcom,57,0,57,42393
2017-01-31,CA,Alameda,6,1,7,399
2022-02-28,CA,San Francisco,0,1,1,76
2019-02-28,WA,Skagit,278,187,465,91208
2022-02-28,WA,Columbia,6,1,7,2457
2017-11-30,CA,San Diego,5,1,6,2584
2017-01-31,WA,Cowlitz,0,0,0,27949
2018-10-31,WA,Grays Harbor,0,0,0,20286
2020-03-31,WA,Pierce,0,0,0,141601
2023-03-31,WA,Chelan,23,0,23,23105
2021-02-28,WA,Kitsap,1642,777,2419,179346
2022-03-31,WA,Clallam,1,0,1,22058
2023-01-31,CA,Riverside,7,0,7,384
2023-07-31,WA,Asotin,0,0,0,6500
2023-04-30,WA,Spokane,34,0,34,101402
2021-05-31,WA,Lincoln,0,0,0,4754
2017-08-31,CA,Tulare,1,0,1,197
2017-02-28,WA,Wahkiakum,0,1,1,2843
2023-06-30,WA,Snohomish,12560,3041,15601,521750
2020-07-31,WA,Wahkiakum,0,0,0,1742
2020-07-31,WA,Island,430,272,702,62871
2019-08-31,WA,Yakima,0,0,0,59390
2020-02-29,WA,Mason,150,135,285,47595
2020-09-30,WA,Snohomish,0,0,0,124936
2019-11-30,WA,Kitsap,1,0,1,54405
2021-03-31,WA,Grays Harbor,150,131,281,49026
2018-12-31,WA,Ferry,0,0,0,3585
2019-11-30,WA,Pend Oreille,0,0,0,5733
2023-03-31,CA,San Bernardino,2,1,3,260
2017-02-28,CA,Monterey,0,1,1,224
2021-07-31,CA,Los Angeles,10,11,21,871
2021-01-31,WA,King,6,1,7,184346
2018-02-28,WA,Clark,888,616,1504,305306
2019-02-28,CA,Shasta,1,0,1,45
2023-02-28,WA,Skamania,93,53,146,8095
2017-08-31,WA,Stevens,8,22,30,31514
2022-11-30,WA,Adams,22,11,33,13032
2017-07-31,WA,Thurston,418,350,768,187062
2022-07-31,WA,Stevens,72,54,126,30084
2017-03-31,WA,Klickitat,21,23,44,14774
2020-09-30,WA,Ferry,0,0,0,3582
2020-11-30,WA,San Juan,355,106,461,14017
2020-04-30,WA,Clallam,219,166,385,50341
2017-03-31,WA,Lewis,45,34,79,55095
2021-06-30,WA,Okanogan,63,38,101,26512
2020-11-30,CA,Kern,0,1,1,216
2019-06-30,WA,Garfield,0,0,0,964
2019-06-30,CA,Ventura,0,2,2,314
2018-04-30,WA,Clark,943,657,1600,306447
2018-03-31,WA,Walla Walla,32,36,68,35462
2018-12-31,WA,Skamania,0,0,0,4008
2018-03-31,WA,Douglas,0,0,0,11857
2022-04-30,WA,Ferry,0,0,0,3568
2022-10-31,WA,Lewis,2,0,2,26372
2023-04-30,WA,Wahkiakum,2,0,2,1779
2023-02-28,WA,Island,977,411,1388,61460
2018-06-30,WA,Thurston,0,0,0,54326
2017-10-31,WA,Mason,61,74,135,44453
2020-06-30,CA,Ventura,1,2,3,278
2017-11-30,WA,Mason,63,72,135,44603
2017-12-31,WA,Grays Harbor,0,0,0,20064
2018-01-31,WA,Spokane,1,0,1,91739
2017-03-31,WA,Douglas,29,19,48,26592
2018-06-30,CA,San Francisco,1,1,2,129
2019-04-30,CA,Shasta,1,0,1,40
2019-05-31,WA,Franklin,0,0,0,19251
2018-12-31,WA,Garfield,1,1,2,1329
2019-06-30,CA,San Joaquin,1,0,1,126
2019-07-31,WA,Skagit,307,210,517,92211
2021-05-31,WA,Columbia,0,0,0,1552
2022-01-31,CA,Solano,1,0,1,172
2023-02-28,CA,San Diego,17,9,26,1971
2018-08-31,WA,Wahkiakum,0,0,0,1691
2018-10-31,WA,Skagit,240,180,420,91010
2023-03-31,WA,Adams,23,11,34,13010
2020-05-31,CA,Sacramento,1,0,1,267
2020-11-30,WA,Benton,426,348,774,134791
2017-07-31,WA,Kittitas,24,19,43,27678
2020-02-29,CA,Placer,2,0,2,93
2017-07-31,WA,Snohomish,1818,920,2738,513286
2017-04-30,WA,Stevens,8,22,30,31233
2019-10-31,WA,Island,362,250,612,63634
2022-09-30,WA,Snohomish,59,0,59,123094
2021-10-31,WA,Garfield,0,3,3,1355
2017-11-30,WA,Walla Walla,29,31,60,35239
2018-05-31,WA,Ferry,0,0,0,3503
2022-02-28,WA,San Juan,485,152,637,14178
2018-05-31,WA,Stevens,11,25,36,31564
2022-07-31,WA,Whitman,88,60,148,21969
2017-07-31,WA,Lincoln,2,5,7,7519
2020-03-31,WA,Wahkiakum,6,5,11,3006
2019-11-30,CA,Santa Cruz,1,0,1,36
2018-11-30,WA,Lincoln,0,0,0,4630
2021-04-30,WA,Pierce,3272,1903,5175,559851
2021-07-31,CA,Alameda,4,0,4,231
2022-07-31,CA,Marin,0,1,1,27
2021-08-31,WA,Whatcom,1520,628,2148,150496
2022-07-31,WA,Pierce,5245,2337,7582,543947
2021-11-30,CA,San Francisco,0,1,1,80
2017-11-30,WA,Wahkiakum,0,2,2,2868
2019-12-31,CA,Santa Clara,7,2,9,351
2017-04-30,WA,Okanogan,0,0,0,16256
2022-02-28,WA,Kittitas,0,0,0,14753
2017-03-31,WA,Grant,17,21,38,60332
2019-06-30,WA,Klickitat,35,32,67,15557
2022-11-30,WA,Ferry,0,0,0,3579
2022-01-31,CA,Alameda,4,0,4,204
2021-01-31,WA,Lewis,0,0,0,26714
2017-11-30,WA,Columbia,2,1,3,2391
2021-02-28,CA,Orange,4,3,7,436
2023-06-30,CA,Contra Costa,0,3,3,182
2023-07-31,WA,Whitman,159,77,236,21502
2020-07-31,WA,Lewis,0,0,0,26284
2020-04-30,WA,Clark,1992,1056,3048,318746
2018-03-31,WA,Yakima,0,0,0,58175
2021-09-30,WA,Okanogan,0,0,0,16701
2023-05-31,WA,Grant,275,122,397,66534
2019-01-31,WA,Grant,0,0,0,26324
2021-10-31,WA,Lewis,0,0,0,26738
2018-08-31,WA,Kitsap,828,488,1316,179328
2017-02-28,WA,Grant,0,0,0,24996
2018-01-31,WA,Pacific,15,13,28,15453
2020-03-31,CA,Santa Clara,7,2,9,324
2020-06-30,WA,Stevens,0,0,0,18645
2020-09-30,WA,Spokane,797,513,1310,318772
2022-01-31,WA,Kitsap,2191,970,3161,179910
2022-09-30,CA,Alameda,4,0,4,169
2020-03-31,WA,Mason,153,135,288,47512
2021-02-28,WA,Whatcom,1277,572,1849,150039
2021-06-30,WA,Jefferson,0,0,0,9625
2020-02-29,WA,Garfield,0,0,0,965
2022-09-30,WA,Wahkiakum,1,0,1,1801
2023-04-30,WA,Douglas,189,61,250,28557
2021-03-31,CA,Riverside,5,1,6,574
2019-01-31,WA,Benton,0,0,0,41617
2021-05-31,WA,Thurston,0,0,0,56635
2018-11-30,CA,Santa Clara,8,1,9,373
2019-08-31,WA,Benton,280,291,571,134343
2023-01-31,WA,Thurston,42,0,42,54598
2017-09-30,WA,Garfield,1,0,1,1295
2020-03-31,CA,San Joaquin,1,0,1,132
2020-06-30,WA,Benton,0,0,0,42703
2021-10-31,WA,Island,679,333,1012,63091
2021-12-31,WA,Douglas,0,0,0,12700
2021-07-31,WA,Okanogan,65,43,108,26539
2019-12-31,WA,Kitsap,1199,652,1851,182349
2018-05-31,WA,Thurston,548,468,1016,192389
2022-12-31,CA,Ventura,2,1,3,205
2017-07-31,WA,Pierce,0,0,0,137369
2021-01-31,WA,Klickitat,63,43,106,14989
2019-07-31,CA,Shasta,1,0,1,40
2021-07-31,WA,Wahkiakum,0,0,0,1793
2019-01-31,WA,Yakima,84,100,184,164930
2018-10-31,WA,Yakima,71,96,167,164423
2023-01-31,WA,Adams,22,11,33,13010
2019-08-31,WA,Pacific,23,29,52,16045
2018-06-30,WA,Stevens,0,0,0,18609
2020-04-30,WA,Cowlitz,136,115,251,72718
2017-06-30,WA,Asotin,0,0,0,6502
2018-06-30,WA,Okanogan,9,19,28,25958
2018-08-31,WA,Cowlitz,0,0,0,28606
2022-09-30,WA,Asotin,0,0,0,6710
2019-04-30,CA,Los Angeles,8,5,13,1095
2017-04-30,WA,Pierce,0,0,0,137818
2018-11-30,WA,Wahkiakum,1,1,2,2984
2022-04-30,CA,San Diego,13,8,21,2307
2021-02-28,CA,Ventura,1,1,2,266
2019-02-28,WA,Yakima,86,101,187,164464
2019-06-30,CA,Fresno,1,0,1,190
2017-07-31,WA,Clallam,93,77,170,48417
2020-04-30,WA,Skagit,1,0,1,32387
2022-09-30,CA,Kern,1,1,2,188
2022-02-28,WA,Jefferson,0,0,0,9576
2017-12-31,CA,Contra Costa,0,1,1,467
2019-01-31,WA,Klickitat,29,32,61,15485
2022-05-31,WA,Franklin,0,0,0,20926
2021-09-30,WA,Ferry,0,0,0,3592
2017-01-31,WA,Walla Walla,16,21,37,34864
2023-01-31,CA,Los Angeles,4,5,9,635
2022-01-31,CA,Santa Clara,8,1,9,228
2022-01-31,WA,Benton,0,0,0,43600
2023-04-30,WA,Whatcom,2323,857,3180,147179
2020-03-31,WA,Whatcom,1057,490,1547,151217
2021-02-28,WA,Island,0,0,0,21432
2020-03-31,WA,Snohomish,4370,1757,6127,537415
2018-04-30,WA,Adams,5,4,9,12523
2020-07-31,WA,Douglas,0,0,0,12352
2023-04-30,WA,Mason,10,0,10,20712
2018-03-31,WA,Pacific,0,0,0,7577
2018-12-31,WA,Clallam,150,124,274,50353
2022-11-30,WA,Asotin,29,20,49,12522
2022-08-31,WA,Island,858,380,1238,61876
2018-08-31,WA,Jefferson,152,101,253,24679
2020-02-29,CA,Contra Costa,3,2,5,331
2022-08-31,WA,Columbia,8,0,8,2437
2019-10-31,CA,Ventura,0,3,3,304
2021-05-31,WA,Yakima,211,145,356,169299
2018-04-30,WA,Lewis,78,51,129,57351
2021-08-31,WA,Spokane,0,0,0,102463
2019-05-31,WA,Cowlitz,95,107,202,72910
2022-12-31,WA,Garfield,0,0,0,976
2022-05-31,WA,Columbia,7,0,7,2441
2019-07-31,CA,Placer,1,0,1,99
2022-05-31,WA,Pierce,5,0,5,142329
2020-02-29,WA,Spokane,696,469,1165,317560
2022-11-30,CA,Contra Costa,0,3,3,209
2018-07-31,CA,Tuolumne,0,1,1,11
2020-05-31,WA,Grays Harbor,0,0,0,20770
2017-11-30,WA,Ferry,0,0,0,3544
2022-06-30,CA,Placer,2,0,2,65
2019-09-30,WA,Cowlitz,0,0,0,28959
2023-06-30,WA,Pacific,4,0,4,7732
2017-04-30,WA,Douglas,31,21,52,26603
2020-03-31,WA,Cowlitz,134,114,248,73167
2018-11-30,CA,San Diego,8,2,10,2565
2022-11-30,WA,Cowlitz,389,188,577,70283
2023-01-31,WA,Skagit,958,364,1322,89336
2023-05-31,WA,Jefferson,549,260,809,24141
2018-10-31,WA,Asotin,0,0,0,6636
2018-05-31,CA,Sacramento,1,0,1,301
2019-07-31,WA,Clark,0,0,0,80613
2017-12-31,CA,Monterey,0,2,2,191
2022-02-28,WA,Pierce,4484,2176,6660,552620
2022-11-30,WA,Jefferson,6,0,6,9386
2017-10-31,WA,Benton,164,155,319,129410
2021-03-31,WA,Walla Walla,107,72,179,36286
2019-06-30,WA,Skamania,23,18,41,8725
2021-10-31,CA,Sacramento,2,0,2,215
2021-11-30,WA,Skamania,0,0,0,4003
2020-11-30,CA,Placer,2,0,2,85
2022-04-30,WA,Benton,1,0,1,43588
2018-06-30,WA,Mason,0,0,0,19955
2022-04-30,WA,Lewis,0,0,0,26439
2017-04-30,WA,Franklin,0,0,0,17995
2019-09-30,WA,Clallam,1,0,1,21843
2020-10-31,CA,San Francisco,1,1,2,90
2022-11-30,WA,Benton,914,491,1405,135879
2019-01-31,WA,Chelan,0,0,0,22107
2017-10-31,WA,Kitsap,1,0,1,52588
2019-05-31,WA,Lincoln,0,0,0,4695
2019-11-30,WA,Cowlitz,0,0,0,29029
2022-05-31,WA,Adams,0,0,0,5475
2022-02-28,WA,Adams,17,14,31,13020
2019-09-30,CA,Solano,1,0,1,207
2018-01-31,WA,Whatcom,1,0,1,42070
2017-10-31,WA,Snohomish,1947,999,2946,515244
2020-04-30,CA,Riverside,3,1,4,629
2021-11-30,WA,King,34716,10089,44805,1362899
2020-12-31,WA,Ferry,9,3,12,4361
2017-10-31,WA,Klickitat,0,0,0,8005
2018-02-28,WA,Jefferson,127,80,207,24312
2020-08-31,WA,Okanogan,40,34,74,25977
2018-09-30,WA,Columbia,2,2,4,2429
2018-02-28,WA,Chelan,94,39,133,53238
2023-02-28,CA,Sonoma,1,1,2,58
2021-10-31,WA,Clark,3253,1514,4767,321077
2021-06-30,WA,Pend Oreille,14,7,21,9267
2023-07-31,CA,Sacramento,5,0,5,117
2022-10-31,WA,Clark,4606,1925,6531,315200
2019-02-28,WA,Snohomish,3146,1498,4644,527664
2020-04-30,WA,Jefferson,234,142,376,24908
2020-10-31,CA,Los Angeles,9,10,19,969
2020-01-31,WA,Columbia,0,0,0,1534
2020-06-30,WA,King,5,1,6,182171
2017-05-31,WA,Yakima,42,55,97,159375
2022-10-31,WA,Spokane,14,0,14,101936
2020-05-31,CA,Solano,1,0,1,206
2023-02-28,WA,Lewis,292,186,478,59690
2022-03-31,CA,Riverside,7,1,8,467
2021-06-30,WA,Kittitas,0,0,0,14785
2019-02-28,WA,Stevens,18,28,46,31733
2022-11-30,CA,Alameda,3,0,3,163
2017-02-28,WA,Benton,0,0,0,39743
2017-11-30,CA,San Mateo,0,1,1,147
2019-01-31,WA,Mason,0,0,0,20224
2022-03-31,WA,Asotin,0,0,0,6757
2018-03-31,CA,Orange,3,1,4,570
2019-01-31,WA,Snohomish,1,0,1,122005
2020-10-31,WA,Walla Walla,0,0,0,13797
2020-10-31,WA,Garfield,0,1,1,1352
2020-10-31,WA,Spokane,828,525,1353,319743
2021-05-31,WA,Benton,0,0,0,43665
2017-01-31,WA,Benton,129,129,258,127860
2023-05-31,WA,Whatcom,2374,867,3241,146794
2021-08-31,WA,Skagit,620,287,907,91723
2017-09-30,WA,Grays Harbor,0,0,0,19976
2022-04-30,WA,Yakima,318,183,501,167415
2019-09-30,WA,Ferry,5,2,7,4423
2019-06-30,WA,Asotin,0,0,0,6667
2019-12-31,CA,San Joaquin,1,0,1,137
2023-03-31,CA,Sacramento,4,0,4,144
2022-05-31,WA,Walla Walla,0,0,0,13969
2018-06-30,WA,Kittitas,0,0,0,14056
2022-05-31,WA,Lincoln,0,0,0,4839
2017-03-31,WA,Adams,0,0,0,5070
2017-06-30,WA,Skagit,140,103,243,88070
2020-01-31,WA,Skagit,1,0,1,32593
2019-05-31,WA,Okanogan,21,23,44,26072
2021-02-28,WA,Klickitat,65,45,110,14999
2022-09-30,WA,Whitman,2,0,2,8588
2022-04-30,WA,Chelan,0,0,0,23067
2019-07-31,WA,Klickitat,0,0,0,8255
2022-05-31,WA,Clallam,410,244,654,49775
2018-11-30,CA,Santa Cruz,1,0,1,40
2022-10-31,WA,Douglas,158,59,217,28437
2020-12-31,WA,Jefferson,285,155,440,24813
2017-01-31,WA,Lewis,0,0,0,24791
2017-12-31,CA,Santa Clara,7,1,8,383
2019-04-30,CA,Orange,6,1,7,529
2019-05-31,WA,Pierce,1751,1520,3271,542054
2021-05-31,CA,Ventura,1,1,2,262
2020-02-29,CA,Sacramento,1,0,1,278
2020-09-30,CA,Kern,0,1,1,223
2018-11-30,WA,Chelan,0,0,0,22082
2021-09-30,WA,Adams,0,0,0,5403
2020-01-31,WA,Spokane,1,0,1,96899
2019-08-31,WA,Grant,45,61,106,65169
2019-10-31,WA,Asotin,0,0,0,6694
2023-06-30,WA,Benton,1136,563,1699,133564
2018-03-31,CA,San Diego,6,1,7,2555
2017-03-31,WA,Mason,0,0,0,19230
2021-06-30,WA,Skagit,1,0,1,33029
2017-01-31,WA,Klickitat,0,0,0,7945
2021-09-30,CA,Los Angeles,7,9,16,847
2021-10-31,WA,Lincoln,7,16,23,7707
2022-02-28,WA,Wahkiakum,0,0,0,1815
2019-09-30,WA,Yakima,0,0,0,59399
2019-03-31,WA,Kitsap,1,0,1,53744
2021-02-28,WA,Yakima,0,0,0,61147
2023-06-30,CA,Kern,1,1,2,158
2017-03-31,WA,Grays Harbor,0,0,0,19865
2018-07-31,WA,King,13479,5802,19281,1372470
2017-05-31,WA,Lincoln,0,0,0,4459
2018-05-31,WA,Lewis,78,54,132,57567
2019-01-31,CA,Kern,0,1,1,232
2019-03-31,CA,Fresno,1,0,1,188
2020-05-31,WA,Yakima,131,117,248,165018
2019-03-31,WA,Kittitas,0,0,0,14249
2018-10-31,WA,Jefferson,163,101,264,24781
2023-01-31,WA,Grant,5,0,5,28035
2019-06-30,WA,Wahkiakum,0,0,0,1755
2022-06-30,WA,San Juan,513,157,670,14067
2018-11-30,WA,Ferry,3,2,5,4383
2019-06-30,WA,Island,317,240,557,63386
2020-07-31,WA,Clallam,237,169,406,50056
2020-11-30,CA,San Diego,14,4,18,2711
2021-04-30,WA,Franklin,109,95,204,61946
2019-09-30,WA,Lewis,107,101,208,59362
2021-02-28,WA,Jefferson,0,0,0,9576
2022-01-31,WA,Pierce,4367,2153,6520,554116
2017-06-30,WA,Spokane,253,208,461,296812
2019-04-30,WA,Asotin,12,8,20,12659
2021-06-30,WA,Klickitat,0,0,0,8301
2020-08-31,CA,Orange,6,2,8,474
2021-01-31,WA,Clallam,281,190,471,49972
2021-03-31,CA,San Diego,14,5,19,2637
2017-08-31,WA,Lewis,55,38,93,55794
2017-12-31,WA,Benton,172,168,340,130229
2020-11-30,WA,Klickitat,0,0,0,8086
2018-04-30,CA,Sacramento,1,0,1,298
2020-04-30,WA,Skamania,29,17,46,8615
2017-06-30,WA,Cowlitz,0,0,0,27913
2021-04-30,CA,Los Angeles,10,11,21,903
2021-02-28,CA,San Mateo,1,1,2,103
2019-07-31,WA,King,5,1,6,182265
2021-12-31,WA,Mason,266,158,424,47764
2021-10-31,WA,Douglas,103,51,154,28576
2019-10-31,CA,Santa Clara,6,2,8,364
2022-08-31,WA,Lincoln,0,0,0,4846
2022-02-28,WA,Asotin,0,0,0,6741
2020-04-30,WA,Stevens,0,0,0,18611
2020-10-31,WA,Douglas,0,0,0,12416
2018-09-30,CA,Los Angeles,7,5,12,1130
2017-06-30,WA,Whatcom,462,175,637,143061
2022-07-31,WA,San Juan,4,0,4,5948
2021-02-28,WA,San Juan,383,118,501,14058
2018-07-31,WA,Adams,5,5,10,12641
2019-06-30,WA,Lewis,0,0,0,25951
2022-08-31,WA,King,42950,11640,54590,1346237
2020-02-29,WA,Klickitat,0,0,0,8301
2019-06-30,WA,Columbia,0,0,0,1532
2022-12-31,CA,Placer,2,0,2,57
2019-11-30,WA,King,6,1,7,182343
2021-09-30,WA,Whatcom,4,0,4,43814
2017-12-31,WA,Douglas,0,0,0,11757
2019-05-31,WA,Ferry,5,2,7,4381
2019-08-31,WA,Kitsap,1,0,1,54161
2018-05-31,WA,Lincoln,0,0,0,4537
2022-07-31,WA,Okanogan,1,0,1,16589
2019-05-31,WA,Douglas,56,36,92,28005
2020-11-30,CA,Santa Clara,6,2,8,270
2018-12-31,WA,Yakima,0,0,0,58848
2022-02-28,WA,Garfield,0,0,0,998
2021-01-31,WA,Thurston,0,0,0,56449
2021-04-30,WA,Klickitat,0,0,0,8248
2019-05-31,WA,Stevens,0,0,0,18677
2018-12-31,WA,Clallam,0,0,0,21642
2018-12-31,WA,Douglas,0,0,0,12160
2020-09-30,WA,Okanogan,45,36,81,25965
2020-11-30,CA,Ventura,1,1,2,269
2023-06-30,CA,Ventura,1,1,2,185
2017-06-30,CA,Monterey,0,1,1,206
2021-08-31,WA,Spokane,1158,684,1842,326045
2021-08-31,WA,Franklin,0,0,0,20720
2019-06-30,WA,Lewis,99,92,191,59123
2018-10-31,WA,Thurston,0,0,0,54803
2018-10-31,WA,Skamania,0,0,0,3983
2019-09-30,WA,Skagit,315,210,525,92513
2018-04-30,WA,Pend Oreille,4,5,9,9474
2020-06-30,CA,San Francisco,1,1,2,93
2022-01-31,WA,Pierce,0,0,0,144454
2020-10-31,WA,Douglas,80,43,123,28068
2017-12-31,WA,Douglas,38,33,71,27171
2019-01-31,CA,San Diego,9,2,11,2582
2023-04-30,CA,Santa Barbara,1,0,1,61
2022-05-31,WA,Douglas,0,0,0,12770
2017-05-31,WA,Okanogan,0,0,0,16215
2022-05-31,WA,Clark,5,0,5,82915
2020-02-29,WA,Lewis,108,105,213,59582
2019-08-31,CA,Santa Cruz,1,0,1,38
2023-04-30,WA,Yakima,468,242,710,165211
2019-02-28,WA,Franklin,0,0,0,19115
2017-04-30,CA,Tulare,1,0,1,194
2017-06-30,WA,Whatcom,2,0,2,41620
2022-07-31,WA,Wahkiakum,0,0,0,1801
2021-05-31,WA,Stevens,42,45,87,30559
2021-03-31,WA,Mason,0,0,0,21168
2020-04-30,WA,Spokane,1,0,1,97398
2021-08-31,WA,Pacific,0,0,0,7973
2022-06-30,WA,Stevens,68,54,122,30173
2021-04-30,WA,Jefferson,0,0,0,9623
2019-07-31,WA,Asotin,0,0,0,6660
2023-06-30,WA,Asotin,0,0,0,6592
2017-07-31,CA,San Mateo,0,1,1,151
2019-04-30,WA,King,18277,6871,25148,1384099
2020-03-31,WA,Thurston,1131,728,1859,198621
2022-09-30,CA,San Joaquin,1,0,1,78
2021-08-31,WA,Yakima,0,0,0,61772
2019-09-30,WA,Kitsap,1135,641,1776,181617
2022-03-31,WA,Benton,1,0,1,43613
2019-05-31,WA,Ferry,0,0,0,3589
2018-01-31,WA,Wahkiakum,0,2,2,2844
2021-05-31,WA,Wahkiakum,13,7,20,3113
2017-10-31,WA,Skagit,1,0,1,31629
2020-05-31,WA,Grant,0,0,0,26982
2020-11-30,CA,San Joaquin,1,0,1,110
2020-09-30,CA,San Diego,15,5,20,2735
2021-11-30,WA,Thurston,1845,949,2794,197125
2019-04-30,WA,Whatcom,2,0,2,42771
2021-06-30,WA,Douglas,93,48,141,28517
2021-02-28,WA,Skamania,37,24,61,8292
2022-06-30,CA,San Bernardino,1,1,2,320
2019-09-30,WA,Clark,1700,982,2682,316090
2018-03-31,WA,Yakima,63,81,144,162826
2022-04-30,WA,San Juan,494,155,649,14128
2023-01-31,WA,Ferry,0,0,0,3552
2021-04-30,WA,Skagit,562,268,830,91975
2019-04-30,WA,Whatcom,823,394,1217,150081
2021-07-31,WA,Pacific,46,53,99,16030
2019-10-31,WA,King,6,1,7,182394
2021-07-31,WA,Klickitat,0,0,0,8313
2023-03-31,WA,Cowlitz,433,195,628,69990
2018-04-30,WA,Pierce,1154,1091,2245,529160
2023-07-31,WA,Kitsap,3267,1302,4569,172227
2022-04-30,CA,San Luis Obispo,1,0,1,55
2022-12-31,WA,Kittitas,5,0,5,14570
2021-11-30,WA,Okanogan,0,0,0,16689
2021-05-31,WA,Garfield,0,2,2,1370
2019-12-31,WA,Asotin,0,0,0,6709
2020-10-31,WA,Grant,0,0,0,27386
2021-02-28,WA,Chelan,0,0,0,22878
2017-02-28,WA,Lewis,45,31,76,54970
2022-06-30,WA,Skagit,780,337,1117,90139
2018-11-30,WA,Okanogan,15,22,37,26132
2019-09-30,WA,Asotin,12,8,20,12631
2017-10-31,CA,Santa Clara,6,1,7,386
2018-09-30,WA,Lewis,0,0,0,25568
2020-12-31,WA,Kittitas,127,51,178,29824
2021-07-31,WA,Lewis,0,0,0,26765
2023-03-31,WA,Columbia,0,0,0,1572
2017-10-31,WA,Thurston,442,371,813,188869
2021-06-30,CA,Placer,2,0,2,77
2019-02-28,WA,Ferry,0,0,0,3592
2020-07-31,WA,Ferry,7,3,10,4330
2021-07-31,WA,Kitsap,0,0,0,54423
2017-02-28,WA,Grant,16,21,37,60193
2021-06-30,CA,Los Angeles,10,11,21,878
2019-08-31,WA,Spokane,1,0,1,95528
2022-04-30,WA,Skagit,1,0,1,32485
2022-12-31,WA,Walla Walla,3,0,3,13871
2021-03-31,WA,Yakima,0,0,0,61384
2017-06-30,WA,Franklin,26,45,71,55615
2018-10-31,WA,Douglas,47,33,80,27894
2020-04-30,WA,King,5,1,6,181518
2019-10-31,WA,Pend Oreille,7,6,13,9493
2018-09-30,WA,Clark,0,0,0,79366
2023-05-31,WA,Skagit,1081,403,1484,88295
2019-06-30,WA,Spokane,1,0,1,94860
2017-03-31,WA,Asotin,0,0,0,6511
2020-07-31,WA,Pierce,0,0,0,142931
2018-05-31,WA,Skagit,1,0,1,32044
2020-07-31,WA,Columbia,0,0,0,1541
2021-07-31,WA,Thurston,0,0,0,56500
2017-01-31,WA,Asotin,4,3,7,12319
2023-03-31,CA,San Diego,17,9,26,1922
2020-12-31,WA,Okanogan,55,36,91,26069
2018-12-31,WA,Columbia,0,0,0,1517
2022-10-31,WA,Stevens,84,56,140,30055
2021-03-31,WA,Kittitas,0,0,0,14757
2019-03-31,WA,Columbia,2,2,4,2427
2022-02-28,WA,Klickitat,0,0,0,8332
2019-06-30,CA,Placer,1,0,1,103
2021-08-31,WA,Kittitas,0,0,0,14782
2020-02-29,WA,Kitsap,1,0,1,54392
2020-08-31,WA,Garfield,0,0,0,994
2019-07-31,WA,Benton,270,289,559,134166
2020-10-31,WA,Benton,0,0,0,43068
2018-03-31,WA,King,7,1,8,183718
2022-04-30,WA,Cowlitz,314,172,486,70917
2017-03-31,WA,King,9317,3787,13104,1382738
2022-09-30,WA,Franklin,231,112,343,61926
2020-10-31,WA,Okanogan,47,36,83,25991
2022-09-30,WA,Yakima,3,0,3,61428
2017-12-31,WA,Jefferson,121,74,195,24283
2021-06-30,WA,Grant,107,89,196,66973
2021-05-31,WA,Thurston,1543,852,2395,198108
2022-03-31,WA,Benton,698,444,1142,135765
2020-06-30,CA,San Diego,14,5,19,2757
2020-06-30,CA,Fresno,1,0,1,180
2017-09-30,CA,San Mateo,0,1,1,147
2020-08-31,CA,Monterey,0,1,1,161
2019-06-30,WA,Lincoln,0,0,0,4676
2020-08-31,WA,Mason,162,133,295,47407
2019-08-31,WA,Skamania,25,18,43,8755
2020-10-31,WA,Clallam,1,0,1,21767
2019-10-31,WA,Okanogan,0,0,0,16523
2018-09-30,WA,Clallam,129,122,251,50164
2018-01-31,WA,Chelan,0,0,0,21676
2021-05-31,WA,Kittitas,155,62,217,29978
2019-11-30,WA,Douglas,65,38,103,28288
2019-06-30,WA,Pend Oreille,4,5,9,9531
2020-09-30,WA,San Juan,0,0,0,5848
2018-02-28,WA,Franklin,0,0,0,18577
2021-03-31,WA,Douglas,0,0,0,12557
2020-04-30,WA,Garfield,0,1,1,1341
2023-05-31,WA,Pend Oreille,0,0,0,5568
2022-06-30,WA,Skagit,3,0,3,32352
2020-02-29,WA,Clark,0,0,0,81980
2020-11-30,WA,Island,480,287,767,62942
2021-02-28,WA,Walla Walla,105,69,174,36134
2021-01-31,WA,Walla Walla,0,0,0,13897
2021-02-28,WA,Whitman,53,46,99,21854
2021-11-30,CA,San Diego,16,8,24,2436
2020-06-30,WA,Skagit,1,0,1,32470
2017-11-30,CA,Los Angeles,5,2,7,1212
2018-11-30,WA,Grays Harbor,61,68,129,47373
2018-08-31,WA,San Juan,0,0,0,5755
2017-09-30,WA,Pacific,0,0,0,7514
2018-10-31,WA,Cowlitz,0,0,0,28666
2020-03-31,WA,Lincoln,0,0,0,4659
2022-09-30,WA,Klickitat,109,53,162,15150
2018-12-31,WA,Benton,227,235,462,132930
2022-07-31,WA,Whatcom,1864,754,2618,148809
2022-06-30,WA,Clallam,421,249,670,49776
2021-07-31,WA,Lincoln,6,15,21,7722
2021-12-31,WA,Lewis,0,0,0,26677
2022-04-30,WA,Stevens,0,0,0,18994
2023-01-31,CA,Santa Barbara,1,0,1,65
2020-09-30,WA,Pacific,0,0,0,7742
2017-12-31,WA,Spokane,1,0,1,91580
2019-10-31,WA,Skagit,336,210,546,92600
2018-12-31,WA,San Juan,0,0,0,5818
2017-03-31,WA,Ferry,0,0,0,3554
2018-09-30,WA,Benton,188,209,397,132434
2017-08-31,WA,Clark,0,0,0,77898
2018-09-30,CA,Orange,4,1,5,549
2023-05-31,WA,Yakima,12,0,12,60495
2022-05-31,WA,Stevens,64,54,118,30097
2017-12-31,WA,Grant,26,35,61,62097
2019-07-31,WA,Jefferson,0,0,0,9683
2022-07-31,WA,Lincoln,9,16,25,7715
2023-01-31,WA,Chelan,556,147,703,54338
2022-02-28,WA,Pend Oreille,0,0,0,5718
2023-04-30,CA,Solano,5,0,5,134
2021-08-31,WA,Walla Walla,121,82,203,36479
2021-03-31,WA,Kitsap,1675,800,2475,179749
2019-09-30,CA,San Diego,10,3,13,2770
2017-10-31,WA,Clark,0,0,0,78122
2017-02-28,WA,King,9098,3713,12811,1385263
2017-02-28,WA,Whatcom,401,146,547,141888
2019-09-30,WA,Island,346,249,595,63481
2021-08-31,CA,San Luis Obispo,1,0,1,58
2021-08-31,WA,Mason,227,147,374,48071
2022-04-30,WA,Walla Walla,0,0,0,14018
2017-08-31,WA,Pacific,10,9,19,15248
2023-07-31,WA,Cowlitz,477,222,699,68070
2021-10-31,WA,Whitman,0,0,0,8556
2019-05-31,WA,Snohomish,1,0,1,122076
2018-09-30,WA,Okanogan,0,0,0,16497
2017-06-30,WA,Walla Walla,25,26,51,34843
2022-02-28,CA,Kern,0,1,1,196
2019-09-30,WA,Asotin,0,0,0,6682
2018-12-31,WA,Thurston,739,572,1311,195602
2019-03-31,WA,Okanogan,20,21,41,25907
2021-09-30,CA,Ventura,1,2,3,253
2017-09-30,WA,Skamania,10,7,17,8572
2021-11-30,CA,Contra Costa,1,4,5,262
2019-08-31,WA,Franklin,51,72,123,60233
2022-11-30,WA,Lewis,260,178,438,59990
2018-11-30,WA,Island,0,0,0,21178
2017-02-28,WA,Stevens,0,0,0,18333
2021-05-31,CA,Santa Cruz,1,0,1,26
2021-06-30,WA,Yakima,0,0,0,61725
2017-11-30,WA,Cowlitz,0,0,0,28144
2023-01-31,WA,Douglas,5,0,5,12874
2018-01-31,WA,Jefferson,124,80,204,24352
2019-03-31,WA,Island,0,0,0,21186
2022-09-30,WA,Grays Harbor,2,0,2,21184
2023-03-31,WA,Wahkiakum,25,16,41,3059
2020-02-29,CA,Ventura,0,3,3,294
2019-03-31,WA,Ferry,3,2,5,4362
2017-03-31,WA,San Juan,88,34,122,13420
2018-07-31,WA,Thurston,0,0,0,54414
2017-05-31,WA,Pierce,0,0,0,137682
2019-08-31,WA,Spokane,575,439,1014,313142
2018-12-31,CA,Los Angeles,7,5,12,1105
2022-10-31,WA,Columbia,8,1,9,2442
2017-03-31,WA,Columbia,0,0,0,1529
2020-08-31,WA,Adams,9,7,16,12868
2018-11-30,WA,Benton,0,0,0,41442
2022-11-30,WA,Island,15,0,15,21264
2023-04-30,WA,Clark,5444,2212,7656,312447
2020-12-31,WA,Asotin,16,13,29,12413
2021-12-31,CA,Riverside,5,1,6,494
2018-09-30,WA,Grays Harbor,55,65,120,47163
2018-10-31,WA,Snohomish,1,0,1,121864
2018-04-30,WA,Clallam,117,105,222,49605
2022-10-31,WA,Chelan,508,140,648,54201
2021-07-31,WA,Adams,16,12,28,13038
2021-03-31,WA,Adams,0,0,0,5375
2019-12-31,WA,Walla Walla,0,0,0,13663
2021-01-31,WA,Clallam,1,0,1,21869
2018-08-31,WA,Clark,1069,765,1834,309220
2019-09-30,CA,San Mateo,2,1,3,119
2017-10-31,WA,Pacific,14,10,24,15322
2019-11-30,CA,San Mateo,1,1,2,121
2017-10-31,CA,Ventura,0,1,1,335
2020-06-30,WA,Pend Oreille,0,0,0,5760
2020-04-30,WA,Pierce,0,0,0,141140
2023-01-31,WA,Klickitat,4,0,4,8231
2018-04-30,CA,San Mateo,1,1,2,133
2018-01-31,CA,Monterey,0,2,2,195
2022-05-31,CA,San Bernardino,1,1,2,323
2023-01-31,CA,Marin,0,1,1,29
2018-09-30,CA,Tuolumne,0,1,1,12
2022-08-31,WA,Klickitat,106,54,160,15196
2023-03-31,WA,Grays Harbor,2,0,2,20979
2021-04-30,CA,Placer,2,0,2,79
2020-07-31,WA,Whatcom,1091,499,1590,149332
2022-12-31,WA,Grays Harbor,2,0,2,21093
2020-07-31,WA,Skagit,1,0,1,32590
2019-08-31,WA,Walla Walla,0,0,0,13652
2021-07-31,WA,Grays Harbor,0,0,0,21418
2023-02-28,WA,Pierce,6593,2579,9172,535692
2019-06-30,WA,Thurston,875,639,1514,197699
2018-10-31,WA,Grant,32,50,82,63918
2021-07-31,CA,Kern,0,1,1,210
2020-11-30,WA,Stevens,0,0,0,18671
2022-08-31,WA,San Juan,530,162,692,13993
2019-12-31,CA,Contra Costa,3,2,5,343
2020-10-31,WA,Skamania,32,20,52,8331
2023-07-31,CA,Solano,5,0,5,123
2018-02-28,WA,Pierce,0,0,0,137016
2020-08-31,CA,Solano,1,0,1,207
2021-01-31,WA,Pacific,0,0,0,7802
2022-04-30,WA,Kittitas,236,77,313,29746
2019-01-31,WA,Island,288,229,517,63253
2017-07-31,WA,Chelan,68,35,103,52135
2018-02-28,CA,Alameda,0,1,1,357
2023-02-28,WA,King,495,2,497,177291
2018-07-31,WA,Jefferson,0,0,0,9588
2023-02-28,WA,Whatcom,44,0,44,42882
2020-05-31,WA,Jefferson,233,141,374,24824
2019-09-30,WA,Lewis,0,0,0,25970
2017-08-31,WA,Klickitat,0,0,0,7970
2018-04-30,WA,Douglas,0,0,0,11882
2021-11-30,WA,Whatcom,1611,660,2271,150227
2021-02-28,WA,Thurston,1383,811,2194,197237
2017-02-28,WA,Whitman,8,18,26,21938
2017-06-30,WA,Ferry,1,1,2,4394
2023-03-31,WA,Franklin,5,0,5,20848
2020-01-31,WA,Thurston,0,0,0,55762
2020-01-31,WA,Clark,1940,1054,2994,319981
2017-10-31,WA,Chelan,77,36,113,52717
2019-12-31,WA,Island,1,0,1,21356
2022-04-30,CA,Solano,1,0,1,160
2018-05-31,WA,Mason,0,0,0,19874
2020-02-29,WA,Grant,0,0,0,27065
2023-01-31,WA,Island,20,0,20,21176
2021-04-30,WA,Pend Oreille,0,0,0,5738
2017-01-31,WA,Douglas,29,19,48,26580
2021-08-31,WA,Clallam,350,220,570,50504
2020-12-31,WA,Skamania,33,22,55,8352
2018-01-31,WA,Benton,0,0,0,40708
2020-12-31,WA,Grays Harbor,0,0,0,21205
2023-05-31,CA,Santa Cruz,1,0,1,12
2019-03-31,WA,Klickitat,0,0,0,8207
2022-12-31,WA,Jefferson,480,230,710,24301
2020-04-30,WA,Ferry,0,0,0,3543
2020-12-31,WA,King,26917,8171,35088,1370135
2017-12-31,WA,Pierce,0,0,0,137028
2019-06-30,WA,Pierce,0,0,0,139794
2018-09-30,WA,Yakima,67,93,160,164243
2019-06-30,WA,Stevens,0,0,0,18659
2022-04-30,WA,Douglas,126,57,183,28526
2020-01-31,CA,Sacramento,1,0,1,284
2022-01-31,WA,Kittitas,0,0,0,14768
2020-04-30,CA,Los Angeles,7,11,18,1001
2019-08-31,WA,Grant,0,0,0,26739
2022-07-31,WA,Franklin,203,110,313,61860
2019-04-30,WA,Douglas,0,0,0,12176
2023-07-31,WA,Kittitas,358,104,462,28484
2019-02-28,WA,Garfield,1,1,2,1324
2021-05-31,CA,Riverside,5,1,6,551
2018-12-31,CA,Santa Cruz,1,0,1,41
2022-02-28,WA,Island,745,351,1096,62408
2020-12-31,CA,San Diego,13,4,17,2708
2018-08-31,WA,Pacific,0,0,0,7624
2018-05-31,WA,Grays Harbor,0,0,0,20185
2019-12-31,WA,Clallam,1,0,1,21871
2022-07-31,CA,Orange,6,2,8,328
2019-06-30,WA,Mason,0,0,0,20361
2019-08-31,WA,Kittitas,0,0,0,14523
2019-10-31,WA,Whitman,0,0,0,8596
2017-04-30,WA,Spokane,1,0,1,90266
2020-05-31,WA,Okanogan,34,33,67,25879
2017-10-31,CA,Tuolumne,0,1,1,15
2023-01-31,WA,Clark,62,0,62,81807
2019-12-31,WA,Pacific,0,0,0,7721
2020-09-30,WA,Benton,394,329,723,134382
2021-09-30,WA,Kittitas,180,72,252,29865
2022-07-31,WA,Ferry,21,4,25,4378
2020-06-30,WA,Garfield,0,0,0,974
2020-05-31,WA,Mason,157,137,294,47178
2021-12-31,WA,Columbia,6,2,8,2452
2017-03-31,WA,Pend Oreille,0,0,0,5583
2017-05-31,WA,Benton,0,0,0,39974
2023-03-31,WA,Douglas,181,59,240,28627
2017-11-30,WA,Cowlitz,54,65,119,70592
2021-07-31,WA,Ferry,9,3,12,4379
2018-01-31,WA,Skamania,0,0,0,3900
2020-01-31,CA,Solano,1,0,1,208
2018-12-31,WA,Kittitas,0,0,0,14196
2021-11-30,WA,San Juan,0,0,0,5996
2019-02-28,WA,Mason,109,117,226,46675
2022-11-30,WA,Clallam,470,261,731,49431
2017-12-31,WA,Whatcom,1,0,1,42016
2023-04-30,CA,Placer,1,0,1,51
2023-07-31,WA,Pend Oreille,0,0,0,5446
2017-10-31,WA,Okanogan,5,17,22,25713
2017-05-31,CA,San Diego,5,1,6,2743
2022-03-31,WA,Walla Walla,157,91,248,36119
2019-01-31,WA,Lewis,0,0,0,25661
2017-11-30,WA,Skagit,159,131,290,89317
2021-07-31,CA,Placer,2,0,2,75
2023-02-28,WA,Spokane,26,0,26,101868
2020-02-29,WA,Cowlitz,0,0,0,28994
2018-12-31,CA,Riverside,2,2,4,677
2020-06-30,WA,Columbia,4,3,7,2415
2018-04-30,WA,Benton,0,0,0,40852
2022-08-31,WA,Grays Harbor,218,163,381,48843
2020-02-29,WA,Skagit,379,215,594,92466
2018-02-28,WA,Spokane,306,263,569,300527
2020-10-31,WA,Franklin,0,0,0,20373
2021-10-31,WA,Kittitas,193,72,265,29844
2023-03-31,WA,Kittitas,7,0,7,14530
2021-06-30,WA,Wahkiakum,0,0,0,1797
2017-09-30,WA,Kitsap,653,346,999,174309
2023-02-28,WA,Ferry,21,4,25,4341
2019-10-31,WA,Grant,55,64,119,65376
2022-01-31,WA,Pacific,55,63,118,16055
2019-10-31,CA,Riverside,4,1,5,646
2023-01-31,CA,San Bernardino,2,1,3,276
2021-01-31,WA,Mason,0,0,0,21024
2019-11-30,WA,Skamania,26,20,46,8789
2017-09-30,WA,Clark,810,542,1352,301404
2017-10-31,WA,Franklin,0,0,0,18324
2023-06-30,WA,Spokane,2298,1094,3392,319256
2020-05-31,WA,Island,409,270,679,62803
2019-07-31,WA,Skamania,0,0,0,4063
2019-10-31,WA,Stevens,0,0,0,18773
2022-09-30,WA,Columbia,0,0,0,1577
2020-07-31,WA,Jefferson,249,142,391,24737
2017-09-30,WA,Lincoln,2,6,8,7563
2019-11-30,WA,Stevens,0,0,0,18795
2017-10-31,WA,Snohomish,1,0,1,121462
2023-07-31,CA,Alameda,3,0,3,132
2021-08-31,CA,Fresno,1,0,1,161
2018-02-28,WA,Columbia,2,1,3,2407
2023-03-31,WA,Skagit,17,0,17,31985
2023-06-30,WA,San Juan,11,0,11,5823
2017-09-30,WA,Island,129,149,278,60853
2020-12-31,WA,Thurston,1321,780,2101,197406
2017-06-30,WA,Jefferson,104,61,165,23850
2020-04-30,WA,Walla Walla,69,63,132,36000
2021-04-30,CA,Riverside,5,1,6,567
2022-03-31,WA,Jefferson,0,0,0,9544
2020-07-31,WA,Asotin,0,0,0,6653
2018-06-30,WA,Skagit,206,166,372,90487
2019-07-31,WA,Mason,127,126,253,47316
2017-11-30,CA,Ventura,0,1,1,327
2018-05-31,WA,Garfield,0,0,0,956
2019-06-30,WA,Thurston,0,0,0,55124
2022-05-31,WA,Jefferson,0,0,0,9493
2017-02-28,WA,San Juan,88,31,119,13403
2022-02-28,CA,Ventura,2,1,3,235
2018-05-31,WA,Thurston,0,0,0,54199
2022-12-31,WA,Klickitat,4,0,4,8233
2021-10-31,WA,Spokane,0,0,0,102587
2019-10-31,WA,Clark,0,0,0,81150
2017-06-30,CA,Marin,1,0,1,59
2021-05-31,WA,Skagit,1,0,1,33056
2022-12-31,WA,Douglas,3,0,3,12825
2023-02-28,CA,Los Angeles,4,5,9,618
2017-04-30,WA,King,8,1,9,188938
2018-08-31,WA,Whatcom,2,0,2,42393
2020-02-29,CA,Shasta,1,0,1,36
2017-07-31,WA,Franklin,0,0,0,18175
2022-06-30,WA,Klickitat,0,0,0,8294
2022-10-31,WA,Whitman,3,0,3,8609
2023-03-31,WA,Grays Harbor,278,179,457,48396
2019-03-31,CA,Riverside,2,2,4,662
2022-10-31,WA,Garfield,0,0,0,977
2018-03-31,WA,Island,0,0,0,20857
2022-12-31,WA,Clark,4917,2031,6948,314946
2023-03-31,WA,Skagit,1026,382,1408,88921
2018-12-31,WA,San Juan,183,69,252,14224
2018-04-30,WA,Klickitat,0,0,0,8070
2020-09-30,WA,Yakima,154,124,278,166493
2018-11-30,WA,Whitman,20,35,55,22795
2022-02-28,WA,Thurston,3,0,3,55853
2017-04-30,WA,Klickitat,0,0,0,7954
2021-11-30,WA,Pacific,0,0,0,8004
2018-07-31,WA,Franklin,38,66,104,58177
2018-08-31,CA,Ventura,0,2,2,315
2018-06-30,CA,San Diego,7,1,8,2582
2023-03-31,WA,Kitsap,58,0,58,52601
2019-04-30,WA,Pacific,0,0,0,7660
2017-07-31,WA,Cowlitz,0,0,0,27954
2022-10-31,WA,Kittitas,5,0,5,14601
2020-02-29,WA,Pend Oreille,8,7,15,9454
2019-08-31,WA,Asotin,12,7,19,12642
2018-09-30,CA,Santa Clara,8,0,8,373
2019-03-31,WA,Skamania,0,0,0,4017
2020-03-31,CA,Orange,7,2,9,500
2018-09-30,WA,Island,0,0,0,21101
2017-06-30,WA,Mason,0,0,0,19273
2021-04-30,WA,Grays Harbor,156,134,290,49368
2021-04-30,WA,Okanogan,0,0,0,16751
2018-01-31,WA,Klickitat,23,26,49,14933
2019-04-30,WA,Chelan,147,66,213,54294
2019-04-30,WA,Pend Oreille,0,0,0,5753
2017-12-31,WA,Thurston,470,391,861,190046
2022-10-31,CA,Sonoma,1,1,2,67
2017-03-31,WA,Wahkiakum,0,0,0,1635
2017-06-30,WA,Pierce,0,0,0,137535
2023-07-31,WA,Cowlitz,10,0,10,27395
2020-06-30,CA,Kern,0,1,1,224
2022-01-31,WA,Grant,0,0,0,27996
2018-09-30,CA,San Diego,7,2,9,2558
2022-06-30,CA,Santa Clara,10,2,12,216
2022-02-28,WA,Grant,0,0,0,28009
2019-10-31,WA,Benton,0,0,0,42370
2017-05-31,WA,Yakima,0,0,0,57281
2020-04-30,CA,Orange,7,2,9,493
2022-01-31,WA,Clallam,391,241,632,50236
2021-04-30,CA,Sacramento,2,0,2,227
2018-11-30,WA,Lincoln,2,6,8,7771
2022-10-31,WA,Wahkiakum,1,0,1,1800
2023-06-30,WA,Kitsap,3208,1283,4491,174228
2023-06-30,WA,Adams,25,12,37,12863
2022-07-31,CA,San Joaquin,1,1,2,81
2020-12-31,CA,Riverside,4,1,5,592
2022-11-30,WA,Clark,4776,1979,6755,315151
2023-04-30,WA,Snohomish,11666,2925,14591,526766
2021-02-28,CA,Placer,2,0,2,79
2019-04-30,WA,Grant,35,60,95,64382
2020-06-30,WA,Mason,0,0,0,20604
2022-12-31,WA,Okanogan,2,0,2,16442
2022-05-31,WA,Kittitas,1,0,1,14675
2017-12-31,WA,Cowlitz,0,0,0,28150
2023-03-31,WA,Garfield,0,0,0,977
2023-05-31,WA,Okanogan,7,0,7,16336
2019-11-30,WA,Stevens,31,30,61,31606
2020-01-31,WA,Clallam,1,0,1,21855
2020-04-30,WA,Thurston,0,0,0,55499
2022-10-31,WA,Whatcom,1993,786,2779,148767
2019-10-31,WA,Wahkiakum,0,0,0,1752
2020-04-30,WA,San Juan,0,0,0,5898
2020-12-31,WA,Cowlitz,177,127,304,72118
2021-04-30,CA,San Diego,16,6,22,2633
2020-01-31,WA,Grant,58,71,129,65624
2020-11-30,WA,Douglas,82,43,125,28127
2017-11-30,WA,Snohomish,1987,1019,3006,516018
2018-07-31,WA,Whitman,0,0,0,8496
2019-10-31,WA,Douglas,0,0,0,12295
2021-12-31,CA,Kern,0,1,1,198
2023-01-31,WA,Pacific,72,81,153,15730
2021-08-31,WA,Okanogan,66,45,111,26473
2019-10-31,CA,Alameda,5,1,6,296
2017-07-31,CA,Santa Clara,5,2,7,399
2021-10-31,WA,Mason,246,156,402,47894
2020-02-29,WA,Douglas,69,40,109,28271
2017-03-31,WA,Clark,0,0,0,77572
2017-09-30,CA,Tuolumne,0,1,1,15
2017-10-31,CA,Alameda,0,1,1,352
2020-06-30,WA,Skagit,407,221,628,91153
2022-07-31,WA,Wahkiakum,24,12,36,3071
2022-05-31,CA,Contra Costa,0,4,4,251
2022-10-31,CA,Alameda,4,0,4,165
2023-06-30,WA,Wahkiakum,2,0,2,1746
2017-01-31,WA,Pierce,822,751,1573,528314
2019-11-30,WA,Adams,6,7,13,12928
2017-12-31,WA,Skagit,167,138,305,89553
2022-07-31,WA,Franklin,1,0,1,20873
2020-10-31,WA,Clallam,252,173,425,49893
2018-01-31,WA,Asotin,8,5,13,12548
2017-06-30,WA,Mason,56,68,124,43451
2020-11-30,WA,Whatcom,3,0,3,43487
2021-12-31,WA,Clark,3474,1562,5036,320347
2017-05-31,WA,Douglas,0,0,0,11484
2018-12-31,WA,Adams,0,0,0,5149
2017-11-30,WA,Pierce,1050,942,1992,526013
2023-01-31,WA,Walla Walla,203,107,310,35733
2020-07-31,WA,Clark,0,0,0,82429
2021-01-31,WA,Lewis,126,131,257,58904
2020-06-30,WA,Stevens,36,33,69,30654
2019-06-30,CA,Tuolumne,0,1,1,12
2023-04-30,WA,Stevens,108,62,170,29693
2019-05-31,WA,Adams,0,0,0,5127
2019-12-31,WA,Spokane,643,471,1114,315064
2018-06-30,WA,Ferry,0,0,0,3512
2021-09-30,CA,Santa Cruz,1,0,1,25
2017-04-30,CA,San Diego,5,1,6,2768
2018-01-31,WA,Jefferson,0,0,0,9485
2020-02-29,WA,Grant,58,70,128,65569
2018-04-30,WA,Whatcom,593,269,862,146611
2023-04-30,WA,Okanogan,3,0,3,16397
2020-08-31,WA,Asotin,0,0,0,6667
2022-11-30,CA,Kings,2,1,3,282
2019-07-31,CA,Solano,1,0,1,215
2022-08-31,WA,Kittitas,3,0,3,14621
2019-02-28,WA,King,17528,6762,24290,1379846
2018-07-31,WA,Island,206,194,400,62580
2020-09-30,WA,Pierce,0,0,0,143993
2022-04-30,WA,Franklin,179,105,284,62000
2020-04-30,WA,Grant,0,0,0,26995
2023-03-31,WA,Pierce,6832,2624,9456,533215
2020-06-30,WA,Yakima,132,119,251,165352
2020-10-31,CA,Santa Cruz,1,0,1,30
2023-06-30,WA,Mason,442,206,648,45684
2019-05-31,CA,Ventura,0,2,2,313
2023-06-30,WA,Jefferson,12,0,12,9231
2023-02-28,WA,Grays Harbor,272,171,443,48597
2019-04-30,WA,Klickitat,33,33,66,15507
2017-12-31,WA,Pierce,1071,963,2034,526446
2022-07-31,WA,Garfield,1,3,4,1326
2017-04-30,WA,Clallam,80,68,148,48127
2021-06-30,CA,Kings,1,0,1,319
2020-09-30,WA,Snohomish,4694,1808,6502,537221
2018-02-28,CA,Riverside,2,2,4,723
2023-06-30,WA,Pend Oreille,30,13,43,8795
2019-11-30,WA,Pierce,2083,1635,3718,547543
2017-01-31,WA,Okanogan,3,15,18,25814
2022-03-31,WA,Grays Harbor,0,0,0,21365
2020-03-31,WA,Columbia,0,0,0,1533
2022-11-30,WA,Grant,220,110,330,66830
2020-05-31,WA,Clallam,1,0,1,21671
2022-12-31,CA,Sacramento,4,0,4,165
2022-05-31,WA,Okanogan,82,51,133,26409
2021-08-31,CA,Riverside,5,1,6,530
2019-10-31,WA,Yakima,0,0,0,59494
2020-08-31,CA,San Francisco,2,1,3,90
2018-08-31,WA,Pierce,1303,1224,2527,534848
2017-12-31,WA,Mason,0,0,0,19593
2020-12-31,WA,Okanogan,0,0,0,16607
2018-05-31,WA,Ferry,2,3,5,4417
2018-11-30,WA,Skagit,249,184,433,91187
2021-01-31,WA,Whatcom,3,0,3,43603
2018-06-30,WA,Chelan,110,53,163,53555
2018-10-31,WA,Benton,192,217,409,132576
2020-06-30,WA,Cowlitz,138,115,253,72319
2017-02-28,WA,Walla Walla,17,21,38,34781
2018-05-31,WA,Pierce,1185,1125,2310,530476
2021-09-30,WA,Spokane,1187,703,1890,326207
2017-05-31,CA,Los Angeles,3,1,4,1325
2023-07-31,WA,Mason,11,0,11,19979
2019-12-31,WA,Pierce,2127,1651,3778,547907
2021-01-31,WA,Whitman,51,46,97,21847
2021-03-31,WA,Franklin,0,0,0,20608
2022-06-30,WA,Chelan,3,0,3,23068
2018-02-28,WA,Lewis,0,0,0,25269
2018-02-28,WA,Snohomish,2088,1119,3207,517277
2023-05-31,WA,Benton,1120,555,1675,134506
2020-06-30,WA,Adams,0,0,0,5263
2019-10-31,WA,Garfield,0,0,0,963
2019-04-30,CA,Fresno,1,0,1,187
2018-07-31,WA,Ferry,0,0,0,3535
2018-06-30,WA,Mason,82,92,174,45712
2019-10-31,WA,Thurston,0,0,0,55645
2019-10-31,CA,Placer,1,0,1,95
2022-03-31,WA,Skamania,0,0,0,3973
2018-09-30,WA,Skamania,15,11,26,8710
2020-07-31,WA,Grays Harbor,0,0,0,20981
2022-11-30,WA,Kitsap,2699,1134,3833,177551
2019-10-31,WA,Kitsap,1177,645,1822,182157
2020-06-30,WA,Franklin,0,0,0,19973
2017-07-31,WA,Stevens,0,0,0,18211
2020-02-29,CA,Kern,0,1,1,223
2020-01-31,WA,Lincoln,1,11,12,7787
2019-07-31,WA,Clallam,1,0,1,21812
2022-08-31,WA,Pierce,5429,2399,7828,542983
2020-07-31,WA,Grant,0,0,0,27176
2021-04-30,WA,Garfield,0,2,2,1376
2019-10-31,WA,Walla Walla,62,62,124,36327
2021-01-31,WA,Ferry,0,0,0,3606
2021-05-31,WA,Mason,207,136,343,48113
2020-02-29,WA,Spokane,1,0,1,97160
2019-12-31,CA,San Mateo,1,1,2,119
2021-05-31,CA,San Diego,16,6,22,2601
2017-03-31,WA,Douglas,0,0,0,11441
2021-03-31,WA,Spokane,0,0,0,101439
2018-06-30,WA,Okanogan,0,0,0,16431
2023-05-31,WA,Skamania,1,0,1,3802
2019-11-30,CA,Placer,1,0,1,96
2017-05-31,WA,Pend Oreille,2,4,6,9313
2017-04-30,WA,Thurston,0,0,0,53255
2017-08-31,WA,Cowlitz,0,0,0,27992
2019-03-31,WA,Island,300,234,534,63126
2021-06-30,WA,Grays Harbor,168,144,312,49450
2023-04-30,WA,Pacific,3,0,3,7787
2017-08-31,WA,Pacific,0,0,0,7515
2018-05-31,WA,Grant,0,0,0,25863
2020-02-29,WA,Wahkiakum,0,0,0,1762
2017-10-31,WA,Jefferson,116,68,184,24072
2017-09-30,CA,Contra Costa,0,1,1,506
2021-04-30,CA,Alameda,3,0,3,243
2019-04-30,WA,Walla Walla,0,0,0,13603
2020-06-30,WA,Spokane,1,0,1,98330
2022-02-28,WA,Chelan,0,0,0,23075
2017-10-31,WA,Columbia,0,0,0,1542
2018-10-31,WA,Pacific,19,23,42,15765
2023-04-30,WA,Cowlitz,8,0,8,28099
2022-11-30,CA,Napa,0,1,1,9
2021-07-31,WA,Asotin,21,17,38,12708
2022-11-30,CA,Los Angeles,5,6,11,672
2018-09-30,WA,Columbia,0,0,0,1521
2017-03-31,CA,Ventura,0,2,2,375
2023-03-31,WA,Spokane,2099,1005,3104,322078
2021-06-30,WA,Yakima,225,155,380,169332
2021-08-31,CA,Los Angeles,10,9,19,849
2021-04-30,WA,Walla Walla,0,0,0,14047
2021-07-31,WA,Skamania,0,0,0,4027
2017-09-30,WA,Clallam,95,83,178,48609
2022-09-30,WA,Adams,1,0,1,5425
2021-02-28,WA,Clallam,1,0,1,21901
2023-04-30,WA,Island,1012,423,1435,61224
2020-04-30,WA,Okanogan,34,31,65,25891
2019-06-30,WA,Asotin,12,8,20,12641
2021-10-31,WA,Cowlitz,258,154,412,71857
2017-05-31,WA,Pierce,933,823,1756,525215
2021-07-31,WA,Thurston,1660,892,2552,197867
2022-08-31,WA,Adams,21,9,30,12974
2022-04-30,WA,Grant,0,0,0,28082
2022-09-30,WA,Okanogan,1,0,1,16528
2019-12-31,WA,Pacific,30,30,60,16120
2023-06-30,WA,Benton,24,0,24,42574
2023-03-31,WA,Adams,2,0,2,5333
2019-07-31,WA,Jefferson,202,118,320,25065
2020-07-31,WA,Stevens,37,35,72,30627
2018-01-31,WA,Lincoln,0,0,0,4504
2017-10-31,WA,Lincoln,0,0,0,4491
2022-02-28,WA,Snohomish,3,0,3,125152
2017-01-31,WA,Thurston,336,299,635,184964
2020-08-31,CA,Kern,0,1,1,221
2020-08-31,WA,Thurston,1194,752,1946,197105
2018-10-31,WA,Chelan,126,59,185,53932
2020-06-30,WA,Benton,359,321,680,134227
2020-03-31,WA,Jefferson,234,141,375,25071
2022-09-30,WA,Wahkiakum,24,12,36,3078
2021-03-31,WA,Okanogan,0,0,0,16672
2017-08-31,WA,Benton,0,0,0,40164
2017-09-30,WA,Jefferson,114,65,179,24008
2017-06-30,WA,Cowlitz,50,60,110,69653
2023-07-31,WA,Adams,3,0,3,5136
2021-01-31,CA,Ventura,1,1,2,268
2018-01-31,WA,Stevens,0,0,0,18391
2021-01-31,WA,Island,527,294,821,62983
2020-01-31,WA,King,6,1,7,182654
2019-01-31,WA,Walla Walla,0,0,0,13535
2021-03-31,WA,Garfield,0,0,0,1012
2017-08-31,WA,Whatcom,481,182,663,143561
2017-03-31,WA,Chelan,55,30,85,51678
2022-11-30,WA,Lincoln,12,19,31,7772
2020-04-30,WA,Stevens,33,33,66,30969
2018-12-31,WA,Whatcom,2,0,2,42664
2021-11-30,CA,Kern,0,1,1,199
2023-06-30,WA,Walla Walla,5,0,5,13510
2017-12-31,WA,Island,0,0,0,20753
2017-06-30,WA,King,10028,4104,14132,1375372
2021-07-31,WA,Kitsap,1911,871,2782,180648
2022-08-31,WA,Grant,198,106,304,66772
2018-10-31,WA,Chelan,0,0,0,22058
2022-05-31,WA,Grant,166,97,263,66720
2019-02-28,WA,Ferry,3,2,5,4377
2020-01-31,WA,Yakima,120,115,235,166247
2020-11-30,WA,Klickitat,62,42,104,14976
2018-01-31,WA,Stevens,10,22,32,31598
2019-10-31,WA,San Juan,0,0,0,5924
2020-05-31,CA,Shasta,1,0,1,36
2017-07-31,WA,Chelan,0,0,0,21329
2021-11-30,WA,Pierce,4130,2111,6241,557334
2021-07-31,WA,Cowlitz,0,0,0,29116
2022-09-30,WA,Garfield,0,0,0,970
2020-06-30,WA,Asotin,0,0,0,6638
2022-10-31,CA,San Diego,17,10,27,2100
2019-10-31,WA,Pend Oreille,0,0,0,5739
2021-05-31,WA,Pierce,0,0,0,145896
2023-05-31,WA,Ferry,20,4,24,4292
2022-03-31,CA,Los Angeles,8,7,15,793
2020-12-31,CA,Placer,2,0,2,83
2022-01-31,WA,Garfield,0,3,3,1356
2017-10-31,WA,Stevens,0,0,0,18305
2022-09-30,CA,San Bernardino,1,1,2,295
2022-09-30,CA,San Mateo,1,0,1,70
2018-03-31,WA,Mason,68,83,151,45217
2021-07-31,WA,Grant,0,0,0,27936
2020-02-29,CA,Tuolumne,0,1,1,10
2021-07-31,CA,San Francisco,0,1,1,84
2017-03-31,WA,Benton,140,139,279,127941
2021-07-31,WA,Skagit,608,281,889,91879
2021-01-31,WA,Pend Oreille,12,3,15,9181
2017-02-28,WA,Grays Harbor,27,24,51,44252
2023-07-31,WA,Douglas,213,65,278,28117
2017-11-30,WA,Chelan,0,0,0,21519
2018-03-31,WA,Skamania,0,0,0,3925
2019-10-31,WA,Jefferson,0,0,0,9672
2019-12-31,WA,Pierce,0,0,0,140864
2023-07-31,WA,Benton,25,0,25,41955
2022-07-31,WA,Grays Harbor,2,0,2,21240
2019-05-31,CA,Santa Cruz,1,0,1,40
2022-05-31,WA,Cowlitz,1,1,2,28601
2022-04-30,WA,Clallam,404,241,645,49821
2020-10-31,WA,Chelan,265,82,347,54374
2021-02-28,WA,Skagit,535,247,782,91350
2020-04-30,WA,Kittitas,101,49,150,29857
2023-04-30,WA,Adams,2,0,2,5293
2022-05-31,WA,Pend Oreille,0,0,0,5629
2018-11-30,WA,Clark,0,0,0,79742
2019-08-31,WA,Yakima,112,108,220,165635
2018-08-31,WA,Thurston,603,517,1120,194254
2018-03-31,WA,Adams,0,0,0,5152
2021-05-31,WA,Okanogan,0,0,0,16755
2023-06-30,WA,Kittitas,8,0,8,14383
2021-12-31,WA,Okanogan,0,0,0,16688
2020-05-31,WA,Douglas,69,40,109,27964
2020-04-30,CA,Tuolumne,0,1,1,10
2019-03-31,CA,Tuolumne,0,1,1,12
2021-06-30,WA,Franklin,0,0,0,20697
2022-10-31,WA,Cowlitz,4,0,4,28459
2020-02-29,WA,Grays Harbor,109,108,217,48374
2018-09-30,CA,Monterey,0,1,1,189
2021-12-31,WA,Whitman,0,0,0,8559
2022-01-31,CA,Placer,2,0,2,71
2018-09-30,WA,Whitman,20,32,52,22690
2019-01-31,WA,Jefferson,0,0,0,9619
2021-10-31,CA,Sonoma,0,1,1,82
2018-05-31,WA,Clallam,119,110,229,49783
2023-06-30,WA,Skamania,104,59,163,7905
2022-04-30,WA,Adams,0,0,0,5481
2020-08-31,WA,Grays Harbor,0,0,0,21033
2019-04-30,WA,Kitsap,1009,575,1584,180200
2021-06-30,WA,San Juan,431,135,566,14255
2018-08-31,WA,Thurston,0,0,0,54562
2019-03-31,WA,Asotin,0,0,0,6632
2021-07-31,CA,Sacramento,2,0,2,213
2017-01-31,WA,King,8,1,9,191085
2017-12-31,WA,Okanogan,0,0,0,16269
2017-01-31,WA,Spokane,1,0,1,90429
2022-04-30,WA,Clallam,1,0,1,21998
2021-04-30,CA,Contra Costa,3,4,7,278
2017-09-30,WA,Chelan,0,0,0,21414
2022-10-31,WA,Franklin,2,0,2,20887
2021-08-31,WA,Kitsap,1952,888,2840,180672
2022-09-30,WA,Kitsap,2572,1110,3682,177870
2023-04-30,WA,Ferry,19,4,23,4330
2019-11-30,WA,Clark,0,0,0,81279
2019-07-31,WA,Ferry,0,0,0,3580
2020-06-30,WA,Thurston,1143,736,1879,196906
2023-03-31,WA,Asotin,31,21,52,12420
2017-07-31,WA,Pacific,10,9,19,15197
2019-11-30,WA,San Juan,243,78,321,14405
2019-10-31,WA,Skamania,0,0,0,4101
2021-12-31,CA,San Bernardino,0,1,1,357
2018-06-30,WA,Grays Harbor,0,0,0,20226
2020-08-31,WA,Chelan,0,0,0,22677
2019-12-31,WA,Stevens,31,31,62,31609
2018-09-30,WA,Klickitat,0,0,0,8137
2020-03-31,WA,Pend Oreille,8,7,15,9369
2020-04-30,CA,San Mateo,0,1,1,116
2017-09-30,WA,Snohomish,1911,975,2886,514376
2021-04-30,WA,Yakima,0,0,0,61656
2017-04-30,WA,Pacific,0,0,0,7464
2017-12-31,WA,Skamania,10,7,17,8589
2018-11-30,WA,Thurston,0,0,0,54923
2022-12-31,CA,Solano,2,0,2,142
2022-05-31,WA,Klickitat,99,54,153,15249
2017-01-31,WA,Walla Walla,0,0,0,13168
2022-02-28,CA,Placer,2,0,2,70
2021-11-30,WA,Walla Walla,137,85,222,36395
2018-06-30,WA,Kittitas,47,32,79,28926
2019-09-30,WA,Kitsap,1,0,1,54211
2017-08-31,WA,Yakima,54,67,121,160149
2020-02-29,WA,Yakima,122,116,238,165956
2020-09-30,WA,Ferry,8,3,11,4305
2021-06-30,WA,Columbia,6,2,8,2468
2022-09-30,WA,Stevens,1,0,1,18922
2017-03-31,WA,Jefferson,0,0,0,9447
2020-03-31,WA,Snohomish,0,0,0,123723
2020-11-30,WA,Wahkiakum,0,0,0,1766
2023-04-30,CA,Monterey,1,1,2,108
2022-04-30,CA,San Joaquin,1,1,2,89
2022-03-31,WA,Garfield,0,3,3,1332
2018-05-31,WA,Klickitat,0,0,0,8084
2019-10-31,CA,Tuolumne,0,1,1,12
2017-11-30,WA,Stevens,10,21,31,31554
2019-06-30,WA,Garfield,1,1,2,1298
2020-01-31,WA,Whatcom,3,0,3,43229
2018-09-30,WA,Pierce,1325,1267,2592,535571
2021-08-31,WA,Adams,16,14,30,13041
2021-09-30,WA,Whitman,0,0,0,8558
2020-04-30,WA,Island,1,0,1,21149
2018-09-30,WA,Grant,33,50,83,63766
2021-02-28,WA,Yakima,184,135,319,167503
2019-06-30,WA,Whatcom,853,428,1281,150709
2021-12-31,WA,Cowlitz,274,163,437,71563
2023-06-30,WA,Stevens,112,68,180,29348
2019-09-30,WA,Kittitas,0,0,0,14565
2022-08-31,CA,Riverside,7,1,8,426
2021-07-31,WA,Douglas,0,0,0,12696
2023-05-31,WA,Spokane,2227,1062,3289,320686
2017-06-30,WA,Clark,0,0,0,77648
2023-05-31,CA,Santa Barbara,1,0,1,60
2019-08-31,CA,Kern,0,1,1,223
2019-06-30,WA,Ferry,0,0,0,3570
2021-07-31,WA,Pierce,3637,2018,5655,559608
2019-11-30,CA,San Diego,9,3,12,2805
2017-04-30,CA,Marin,1,0,1,60
2020-03-31,WA,Adams,0,0,0,5219
2022-05-31,WA,Lewis,231,173,404,59518
2018-01-31,WA,Okanogan,7,19,26,25706
2020-03-31,CA,Contra Costa,3,2,5,327
2017-06-30,WA,Whitman,10,20,30,22038
2022-12-31,WA,King,386,2,388,178383
2020-09-30,WA,Clallam,245,173,418,49886
2019-02-28,WA,Thurston,0,0,0,54906
2022-11-30,WA,Grant,4,0,4,27996
2023-03-31,WA,Whatcom,48,0,48,42816
2018-04-30,WA,Walla Walla,34,40,74,35454
2017-05-31,WA,Columbia,0,0,0,1537
2021-08-31,WA,Skamania,0,0,0,4036
2020-12-31,WA,Jefferson,0,0,0,9588
2023-01-31,WA,Kitsap,2835,1163,3998,177157
2018-10-31,WA,San Juan,169,69,238,14212
2017-09-30,WA,Walla Walla,0,0,0,13243
2018-03-31,WA,Chelan,96,41,137,53348
2020-01-31,WA,Pend Oreille,0,0,0,5778
2021-03-31,WA,Snohomish,1,0,1,125936
2019-12-31,WA,Yakima,0,0,0,59618
2018-12-31,WA,Lewis,93,77,170,58326
2018-05-31,WA,Klickitat,25,30,55,15106
2023-07-31,WA,Skamania,105,56,161,7814
2022-07-31,WA,Kittitas,278,86,364,29692
2018-12-31,WA,Whatcom,757,371,1128,149448
2021-07-31,WA,Island,625,316,941,63232
2020-12-31,CA,Ventura,1,1,2,272
2018-11-30,CA,San Mateo,2,1,3,128
2019-02-28,WA,Clallam,0,0,0,21577
2017-03-31,CA,Marin,1,0,1,59
2022-07-31,WA,Lincoln,0,0,0,4833
2020-05-31,WA,Asotin,0,0,0,6587
2017-11-30,WA,King,7,1,8,185511
2023-05-31,WA,Whitman,144,76,220,21873
2020-01-31,WA,Kittitas,93,47,140,30081
2020-06-30,CA,Sacramento,1,0,1,264
2019-05-31,CA,Los Angeles,8,5,13,1098
2020-03-31,WA,King,23884,7720,31604,1397089
2018-10-31,WA,Whatcom,700,341,1041,148806
2022-04-30,WA,Spokane,0,0,0,102417
2020-02-29,WA,Lewis,0,0,0,26101
2018-08-31,WA,Columbia,2,2,4,2415
2020-01-31,WA,Grays Harbor,0,0,0,20827
2022-05-31,CA,Ventura,1,1,2,229
2019-05-31,WA,Lincoln,3,8,11,7772
2020-06-30,CA,Santa Cruz,1,0,1,32
2017-08-31,WA,San Juan,113,39,152,13645
2023-04-30,WA,Walla Walla,213,115,328,35303
2021-11-30,WA,Kittitas,0,0,0,14805
2017-03-31,WA,Okanogan,0,0,0,16304
2022-01-31,CA,San Mateo,2,0,2,77
2017-08-31,WA,Snohomish,1,0,1,121668
2021-09-30,CA,San Francisco,0,1,1,82
2021-08-31,WA,Grays Harbor,177,147,324,49506
2017-03-31,WA,Stevens,6,20,26,31284
2019-04-30,CA,Santa Clara,8,1,9,362
2017-04-30,WA,Columbia,0,0,0,1536
2021-04-30,WA,King,6,1,7,184931
2018-03-31,CA,Sacramento,1,0,1,294
2018-12-31,WA,Mason,107,110,217,46462
2018-01-31,CA,Marin,1,0,1,56
2022-11-30,WA,Whatcom,21,0,21,43111
2023-02-28,WA,Douglas,180,59,239,28618
2022-08-31,CA,San Bernardino,1,1,2,302
2017-01-31,WA,Jefferson,0,0,0,9469
2023-06-30,WA,Garfield,1,3,4,1291
2022-01-31,WA,Franklin,0,0,0,20891
2021-08-31,WA,Stevens,48,44,92,30285
2017-02-28,WA,Klickitat,0,0,0,7937
2020-07-31,WA,Asotin,16,12,28,12378
2017-03-31,WA,Clallam,77,65,142,48078
2017-02-28,CA,San Diego,4,1,5,2821
2023-06-30,WA,Lewis,7,0,7,25651
2018-04-30,WA,Spokane,318,288,606,301923
2019-08-31,WA,Cowlitz,107,108,215,73286
2022-05-31,CA,Los Angeles,8,8,16,763
2019-11-30,CA,San Francisco,2,1,3,100
2021-10-31,WA,Franklin,144,102,246,62082
2020-02-29,WA,Pierce,0,0,0,141517
2022-04-30,WA,Asotin,0,0,0,6749
2019-09-30,WA,Thurston,953,672,1625,198595
2017-12-31,WA,Kittitas,0,0,0,13805
2018-11-30,WA,King,6,1,7,182760
2021-04-30,CA,Orange,4,3,7,434
2021-01-31,WA,Asotin,16,13,29,12441
2020-04-30,WA,Okanogan,0,0,0,16384
2018-04-30,WA,Adams,0,0,0,5150
2021-09-30,WA,King,5,1,6,183901
2022-11-30,WA,Spokane,19,0,19,101973
2018-10-31,WA,Spokane,383,352,735,306205
2018-01-31,WA,Asotin,0,0,0,6559
2018-11-30,WA,Douglas,0,0,0,12123
2022-02-28,WA,Yakima,301,178,479,168019
2017-02-28,WA,Klickitat,20,22,42,14768
2020-06-30,WA,Klickitat,53,41,94,15173
2020-09-30,CA,Alameda,2,0,2,263
2023-01-31,WA,Yakima,435,228,663,166438
2017-11-30,WA,Grays Harbor,42,41,83,45582
2023-05-31,WA,Jefferson,12,0,12,9267
2018-08-31,WA,Mason,0,0,0,20084
2019-03-31,WA,Stevens,0,0,0,18708
2020-03-31,WA,Clark,0,0,0,82047
2018-02-28,WA,Spokane,1,0,1,91721
2022-07-31,WA,Skagit,813,345,1158,89848
2022-03-31,WA,San Juan,492,152,644,14129
2020-07-31,CA,Santa Clara,8,2,10,284
2020-10-31,WA,Cowlitz,0,0,0,28894
2019-01-31,WA,Kittitas,0,0,0,14237
2017-09-30,WA,Pend Oreille,0,0,0,5552
2022-07-31,WA,Lewis,246,177,423,59694
2019-09-30,WA,Pend Oreille,6,6,12,9472
2020-12-31,WA,Clark,0,0,0,83498
2018-12-31,WA,Mason,0,0,0,20192
2019-06-30,WA,Pacific,25,29,54,15975
2018-07-31,WA,Franklin,0,0,0,18741
2020-10-31,WA,Kittitas,0,0,0,14630
2022-09-30,WA,Cowlitz,3,0,3,28470
2022-05-31,WA,Okanogan,0,0,0,16665
2020-09-30,WA,Skagit,1,0,1,32643
2019-08-31,CA,San Joaquin,1,0,1,131
2020-09-30,WA,Garfield,0,0,0,987
2021-09-30,WA,Mason,0,0,0,21291
2020-03-31,WA,Franklin,58,77,135,61018
2021-01-31,WA,Okanogan,56,36,92,26138
2017-05-31,WA,Skamania,9,7,16,8532
2021-05-31,CA,Kern,0,1,1,211
2018-03-31,WA,Lincoln,0,0,0,4515
2020-06-30,WA,Clark,2014,1058,3072,317682
2023-04-30,CA,Orange,7,2,9,269
2019-08-31,WA,Snohomish,3641,1640,5281,533107
2020-11-30,WA,Skagit,481,235,716,91415
2022-01-31,WA,Ferry,14,3,17,4436
2021-08-31,CA,San Mateo,1,0,1,93
2021-12-31,WA,Whatcom,1643,673,2316,149995
2018-12-31,CA,San Francisco,2,1,3,115
2018-10-31,WA,Clallam,0,0,0,21569
2018-06-30,WA,Yakima,0,0,0,58487
2019-11-30,WA,Thurston,0,0,0,55656
2021-03-31,CA,El Dorado,1,0,1,30
2017-07-31,CA,Monterey,0,2,2,199
2017-07-31,WA,Grant,0,0,0,25271
2020-04-30,WA,Mason,155,135,290,47212
2021-12-31,WA,Yakima,286,173,459,168770
2019-05-31,WA,Thurston,844,630,1474,197138
2021-10-31,WA,Skamania,0,0,0,4019
2021-11-30,WA,Klickitat,88,52,140,15349
2017-06-30,WA,Pend Oreille,3,4,7,9316
2022-01-31,WA,San Juan,1,0,1,6022
2020-10-31,WA,Adams,8,7,15,12936
2019-01-31,WA,Skagit,1,0,1,32319
2023-07-31,WA,Chelan,641,165,806,52924
2017-11-30,WA,San Juan,0,0,0,5574
2017-10-31,WA,Garfield,1,0,1,1315
2020-06-30,CA,Los Angeles,7,11,18,984
2020-07-31,CA,San Francisco,2,1,3,91
2019-08-31,WA,Douglas,61,36,97,28181
2020-07-31,WA,Pend Oreille,7,5,12,9246
2019-02-28,WA,Skamania,0,0,0,3990
2017-05-31,WA,Mason,51,66,117,43298
2021-09-30,WA,Lincoln,7,16,23,7682
2020-07-31,WA,Kittitas,0,0,0,14564
2023-02-28,CA,San Joaquin,1,0,1,73
2023-06-30,WA,Adams,3,0,3,5232
2017-04-30,WA,Lincoln,2,4,6,7481
2021-11-30,WA,Cowlitz,0,1,1,29027
2023-06-30,WA,Pacific,76,88,164,15453
2019-11-30,CA,Orange,7,2,9,505
2022-02-28,WA,Grant,142,99,241,66798
2021-03-31,CA,Orange,4,3,7,440
2019-11-30,WA,Mason,140,130,270,47611
2018-11-30,WA,Skamania,0,0,0,4005
2020-12-31,CA,Kern,0,1,1,216
2019-04-30,WA,Kittitas,71,35,106,29489
2022-09-30,WA,Kittitas,290,91,381,29618
2021-07-31,WA,Franklin,0,0,0,20725
2021-05-31,CA,Monterey,0,1,1,148
2022-12-31,WA,Clark,51,0,51,81917
2020-08-31,WA,King,25173,7814,32987,1370893
2017-07-31,WA,Skagit,1,0,1,31485
2017-02-28,WA,Asotin,0,0,0,6475
2023-07-31,WA,Okanogan,7,0,7,15946
2019-09-30,WA,Grays Harbor,89,89,178,48096
2022-08-31,WA,Wahkiakum,1,0,1,1802
2021-05-31,WA,Yakima,0,0,0,61680
2020-07-31,WA,Garfield,0,0,0,988
2017-12-31,WA,Walla Walla,0,0,0,13292
2022-05-31,WA,Asotin,0,0,0,6709
2018-11-30,WA,Kitsap,916,522,1438,180341
2020-10-31,WA,Ferry,8,3,11,4351
2023-02-28,WA,Thurston,49,0,49,54485
2019-07-31,WA,Snohomish,0,0,0,122619
2021-05-31,WA,Spokane,1030,624,1654,325579
2019-01-31,WA,Okanogan,18,21,39,26053
2020-12-31,CA,Contra Costa,3,3,6,278
2017-03-31,WA,San Juan,0,0,0,5583
2019-08-31,WA,Garfield,0,0,0,959
2021-02-28,CA,Santa Clara,7,2,9,263
2021-12-31,CA,Los Angeles,8,7,15,825
2021-12-31,CA,Sonoma,0,1,1,80
2020-03-31,WA,Franklin,0,0,0,19901
2019-12-31,WA,Skagit,1,0,1,32566
2019-09-30,WA,Skamania,0,0,0,4086
2020-11-30,CA,San Francisco,1,1,2,89
2019-11-30,WA,Benton,310,308,618,135108
2020-07-31,WA,Cowlitz,146,117,263,72232
2018-04-30,WA,Pacific,0,0,0,7596
2023-03-31,WA,Lincoln,0,0,0,4848
2019-04-30,WA,Mason,0,0,0,20326
2021-07-31,WA,Chelan,0,0,0,23102
2022-12-31,WA,Lincoln,0,0,0,4848
2020-12-31,WA,Snohomish,0,0,0,125700
2020-09-30,WA,Lewis,0,0,0,26446
2018-02-28,WA,Whitman,0,0,0,8453
2019-10-31,WA,Benton,307,302,609,134942
2020-01-31,WA,Pierce,2229,1679,3908,550655
2021-07-31,WA,Benton,540,397,937,136282
2017-01-31,WA,Pacific,5,6,11,15034
2018-06-30,WA,Yakima,60,88,148,163780
2020-10-31,WA,Kittitas,121,49,170,29701
2022-08-31,CA,Contra Costa,0,4,4,227
2021-04-30,WA,King,29460,8753,38213,1369496
2021-09-30,WA,Yakima,0,0,0,61737
2022-05-31,WA,Yakima,325,189,514,167089
2017-03-31,WA,Whatcom,416,156,572,142234
2023-07-31,WA,San Juan,16,0,16,5767
2019-04-30,WA,Pend Oreille,4,5,9,9505
2022-06-30,WA,Lincoln,0,0,0,4832
2021-05-31,CA,Placer,2,0,2,80
2019-05-31,WA,Adams,5,6,11,12714
2021-08-31,WA,Pend Oreille,0,0,0,5726
2022-07-31,WA,Garfield,0,0,0,976
2018-02-28,CA,Tuolumne,0,1,1,14
2021-10-31,CA,Solano,1,0,1,177
2023-05-31,WA,Mason,10,0,10,20553
2022-11-30,WA,Whitman,3,0,3,8630
2017-12-31,WA,Yakima,0,0,0,58011
2023-07-31,WA,Ferry,0,0,0,3476
2022-04-30,CA,Orange,5,2,7,357
2021-07-31,WA,Snohomish,1,0,1,126198
2023-04-30,WA,Skamania,99,53,152,8037
2020-10-31,WA,Pacific,34,34,68,15725
2022-12-31,WA,Skagit,924,355,1279,89464
2019-11-30,WA,Whatcom,964,470,1434,151593
2022-05-31,CA,San Diego,14,9,23,2265
2018-06-30,WA,Asotin,9,6,15,12602
2023-03-31,WA,Clark,5285,2161,7446,313218
2017-11-30,WA,Island,147,156,303,61346
2018-01-31,CA,Santa Clara,7,1,8,389
2023-01-31,WA,Garfield,1,3,4,1319
2022-08-31,CA,Sacramento,3,0,3,184
2018-11-30,CA,Shasta,1,0,1,42
2020-01-31,WA,Kitsap,1258,656,1914,182446
2020-06-30,CA,Alameda,2,0,2,268
2022-01-31,WA,Chelan,421,117,538,54587
2023-02-28,WA,Skagit,13,0,13,32041
2022-01-31,WA,Thurston,1920,973,2893,196481
2022-04-30,WA,Wahkiakum,20,11,31,3079
2018-01-31,WA,Thurston,487,407,894,190668
2022-02-28,WA,Walla Walla,0,0,0,14072
2020-04-30,WA,Pacific,30,34,64,15837
2017-09-30,WA,San Juan,117,42,159,13676
2021-02-28,WA,Whatcom,3,0,3,43636
2019-09-30,CA,Santa Clara,4,2,6,358
2021-04-30,WA,Benton,496,377,873,136100
2017-05-31,WA,Kitsap,1,0,1,52377
2020-10-31,WA,Mason,165,134,299,47497
2021-03-31,WA,Clark,0,0,0,83850
2017-06-30,WA,Garfield,0,0,0,1295
2020-03-31,WA,Benton,0,0,0,42519
2023-03-31,CA,Placer,1,0,1,52
2020-06-30,WA,Pierce,0,0,0,142167
2023-07-31,WA,Clark,5943,2342,8285,305963
2023-06-30,WA,Lincoln,16,18,34,7573
2019-12-31,WA,Snohomish,4021,1709,5730,536109
2020-12-31,CA,San Joaquin,1,0,1,108
2019-03-31,WA,San Juan,0,0,0,5811
2021-04-30,WA,Benton,0,0,0,43685
2017-02-28,WA,King,8,1,9,190501
2018-07-31,WA,Chelan,0,0,0,21950
2019-05-31,WA,Mason,121,120,241,47012
2022-01-31,WA,Klickitat,90,54,144,15313
2018-05-31,WA,Snohomish,2281,1223,3504,520051
2022-10-31,WA,Okanogan,1,0,1,16478
2021-02-28,WA,Whitman,0,0,0,8514
2022-11-30,WA,Lewis,2,0,2,26343
2022-04-30,WA,Kittitas,0,0,0,14715
2020-05-31,WA,Mason,0,0,0,20508
2022-08-31,WA,Klickitat,2,0,2,8267
2022-01-31,WA,Kittitas,216,71,287,29812
2020-10-31,WA,Wahkiakum,6,6,12,3035
2022-12-31,WA,Clallam,8,0,8,21879
2017-12-31,WA,Garfield,1,0,1,1321
2022-12-31,WA,Benton,933,500,1433,135784
2018-03-31,WA,Franklin,34,55,89,57213
2019-10-31,CA,Orange,7,3,10,510
2020-09-30,WA,Columbia,4,3,7,2421
2020-08-31,WA,Benton,0,0,0,43024
2018-12-31,WA,Thurston,0,0,0,54873
2019-05-31,WA,Jefferson,0,0,0,9668
2020-07-31,WA,Jefferson,0,0,0,9542
2021-06-30,WA,Kittitas,160,67,227,29984
2017-05-31,WA,Grant,0,0,0,25222
2021-03-31,WA,Lincoln,5,13,18,7691
2021-03-31,WA,Cowlitz,0,0,0,29052
2021-02-28,CA,Fresno,1,0,1,169
2023-02-28,CA,Santa Barbara,1,0,1,63
2019-08-31,WA,Kittitas,79,44,123,29744
2020-02-29,WA,Ferry,0,0,0,3582
2019-09-30,WA,Klickitat,38,36,74,15624
2017-09-30,WA,Yakima,57,69,126,160618
2021-06-30,WA,Clallam,329,217,546,50489
2019-09-30,WA,Okanogan,24,26,50,26237
2021-04-30,WA,Adams,0,0,0,5406
2017-09-30,WA,Columbia,0,0,0,1557
2021-01-31,WA,Columbia,5,3,8,2452
2021-08-31,WA,Klickitat,82,51,133,15361
2018-11-30,CA,Orange,5,2,7,544
2019-03-31,WA,Wahkiakum,0,0,0,1725
2022-10-31,WA,Lewis,261,179,440,59898
2023-02-28,WA,Asotin,30,20,50,12475
2021-03-31,WA,Skagit,539,260,799,91602
2021-03-31,WA,Clallam,299,199,498,50123
2017-05-31,WA,Klickitat,0,0,0,7967
2019-06-30,WA,Grays Harbor,0,0,0,20455
2019-09-30,WA,Klickitat,0,0,0,8298
2017-08-31,WA,Wahkiakum,0,0,0,1655
2018-05-31,CA,Ventura,0,1,1,315
2022-08-31,WA,Okanogan,1,0,1,16543
2022-07-31,WA,Benton,3,0,3,43487
2017-04-30,WA,Grant,0,0,0,25091
2017-08-31,WA,Garfield,1,0,1,1302
2017-01-31,CA,San Mateo,0,1,1,177
2020-01-31,WA,Thurston,1093,719,1812,199295
2018-05-31,WA,Skamania,12,9,21,8704
2018-10-31,CA,San Diego,8,2,10,2561
2021-12-31,WA,Columbia,0,0,0,1555
2023-03-31,WA,Pacific,74,84,158,15627
2022-05-31,WA,Garfield,0,0,0,981
2018-10-31,CA,Santa Clara,8,0,8,373
2022-11-30,WA,Grays Harbor,3,0,3,21117
2021-08-31,WA,Chelan,0,0,0,23088
2017-09-30,WA,Mason,0,0,0,19379
2022-09-30,WA,San Juan,6,0,6,5955
2018-12-31,WA,Island,0,0,0,21185
2017-11-30,CA,Marin,1,0,1,57
2022-09-30,WA,Lewis,252,176,428,59836
2018-09-30,WA,Snohomish,1,0,1,121775
2023-07-31,WA,Lewis,7,0,7,25247
2020-02-29,WA,Walla Walla,0,0,0,13701
2018-10-31,WA,Okanogan,0,0,0,16501
2017-02-28,WA,Ferry,2,1,3,4391
2017-07-31,WA,Okanogan,4,18,22,25634
2020-01-31,WA,Columbia,3,3,6,2447
2020-12-31,WA,Stevens,36,40,76,30234
2017-12-31,CA,Los Angeles,5,2,7,1209
2017-11-30,CA,Contra Costa,0,1,1,470
2021-07-31,WA,Pierce,0,0,0,145859
2018-08-31,WA,Grant,0,0,0,26008
2018-12-31,WA,Garfield,0,0,0,965
2019-05-31,WA,Whatcom,837,413,1250,150441
2019-07-31,WA,Asotin,12,8,20,12658
2019-02-28,WA,Franklin,50,70,120,59299
2023-05-31,WA,Lincoln,16,17,33,7646
2018-06-30,WA,Grant,31,45,76,63139
2019-09-30,CA,Ventura,0,2,2,305
2018-03-31,WA,King,11972,5152,17124,1367947
2018-07-31,WA,Skagit,215,171,386,90712
2020-04-30,CA,San Francisco,2,1,3,98
2017-08-31,CA,Monterey,0,2,2,195
2018-06-30,WA,Whatcom,631,301,932,147658
2023-01-31,WA,Snohomish,113,0,113,122400
2019-02-28,WA,Spokane,1,0,1,93888
2020-12-31,WA,Grays Harbor,127,122,249,48651
2022-01-31,WA,Clark,2,0,2,83892
2019-12-31,CA,Los Angeles,7,9,16,1062
2020-05-31,CA,Ventura,1,2,3,283
2018-07-31,CA,Riverside,2,2,4,693
2018-08-31,WA,Lincoln,3,6,9,7748
2019-08-31,CA,Alameda,4,1,5,294
2018-01-31,WA,Adams,0,0,0,5148
2023-05-31,WA,Clallam,533,280,813,48629
2020-05-31,WA,San Juan,0,0,0,5860
2021-05-31,CA,Sacramento,2,0,2,221
2021-05-31,WA,Franklin,117,95,212,61959
2020-05-31,WA,Whitman,0,0,0,8514
2019-08-31,WA,Pacific,0,0,0,7681
2019-02-28,WA,Snohomish,1,0,1,121877
2018-08-31,WA,Chelan,114,55,169,53723
2023-05-31,WA,Columbia,9,1,10,2407
2018-08-31,WA,Pend Oreille,0,0,0,5718
2019-05-31,WA,Pacific,24,28,52,15952
2022-11-30,WA,Columbia,0,0,0,1591
2022-07-31,WA,Pierce,20,0,20,141272
2019-09-30,CA,Alameda,4,1,5,295
2020-11-30,WA,Snohomish,0,0,0,125469
2020-05-31,WA,Garfield,0,1,1,1347
2018-05-31,WA,Pend Oreille,0,0,0,5671
2020-09-30,WA,Klickitat,58,42,100,15023
2021-03-31,WA,Island,556,299,855,63006
2019-11-30,WA,Grays Harbor,0,0,0,20750
2018-07-31,WA,Thurston,577,497,1074,193753
2020-07-31,WA,King,24904,7756,32660,1371156
2023-02-28,CA,Placer,1,0,1,53
2018-10-31,CA,Ventura,0,2,2,314
2017-02-28,WA,Pend Oreille,0,0,0,5573
2021-12-31,WA,Skamania,60,42,102,8323
2022-05-31,CA,Santa Cruz,1,0,1,23
2021-07-31,WA,Whatcom,4,0,4,43871
2020-12-31,WA,Pacific,0,0,0,7792
2022-12-31,WA,Lincoln,12,18,30,7769
2017-12-31,WA,Wahkiakum,0,0,0,1670
2022-08-31,WA,Clark,17,0,17,82407
2018-09-30,WA,Kitsap,841,499,1340,179462
2023-03-31,WA,Skamania,95,53,148,8092
2019-02-28,CA,Contra Costa,1,2,3,393
2020-09-30,WA,King,25389,7895,33284,1371586
2020-12-31,WA,Spokane,0,0,0,100712
2017-09-30,WA,Jefferson,0,0,0,9419
2020-10-31,WA,Skamania,0,0,0,3995
2021-11-30,WA,Asotin,0,0,0,6760
2018-02-28,WA,Chelan,0,0,0,21668
2022-03-31,WA,Kittitas,0,0,0,14720
2018-08-31,WA,Benton,189,198,387,132209
2021-06-30,WA,Lewis,163,139,302,59680
2022-02-28,CA,San Bernardino,1,1,2,344
2019-09-30,CA,San Francisco,2,1,3,105
2022-08-31,WA,Franklin,224,113,337,61955
2019-06-30,CA,Kern,0,1,1,222
2019-09-30,WA,Pierce,1966,1602,3568,545437
2017-07-31,WA,Jefferson,107,61,168,23895
2019-09-30,WA,Whitman,36,45,81,22710
2022-06-30,WA,Garfield,0,3,3,1322
2022-10-31,WA,King,45341,11925,57266,1343327
2020-10-31,WA,Asotin,0,0,0,6685
2021-05-31,CA,Santa Clara,8,3,11,255
2017-09-30,WA,Clark,0,0,0,77868
2018-09-30,WA,Whatcom,666,335,1001,148503
2017-03-31,WA,Island,0,0,0,20500
2022-05-31,CA,Alameda,4,0,4,185
2019-11-30,WA,Whitman,41,46,87,22704
2020-03-31,WA,Garfield,0,0,0,976
2019-09-30,WA,Island,0,0,0,21294
2022-04-30,WA,Whatcom,4,0,4,43460
2021-09-30,CA,San Mateo,1,0,1,88
2019-07-31,WA,Benton,0,0,0,42072
2021-04-30,WA,Franklin,0,0,0,20683
2018-10-31,WA,Clallam,136,119,255,50301
2017-05-31,WA,Adams,2,3,5,12197
2020-12-31,CA,Fresno,1,0,1,169
2017-10-31,WA,Chelan,0,0,0,21490
2017-05-31,CA,Santa Clara,5,2,7,402
2020-09-30,WA,Benton,0,0,0,43090
2019-08-31,WA,Clallam,1,0,1,21824
2022-02-28,WA,Kittitas,218,72,290,29778
2022-08-31,WA,Lewis,243,177,420,59723
2022-06-30,WA,Franklin,0,0,0,20900
2020-08-31,CA,Fresno,1,0,1,172
2021-01-31,CA,San Francisco,1,1,2,89
2020-11-30,WA,Grant,78,79,157,65766
2022-01-31,WA,Grays Harbor,197,158,355,49346
2017-02-28,WA,Whatcom,2,0,2,41327
2021-04-30,WA,Yakima,206,139,345,169220
2021-04-30,WA,Jefferson,310,178,488,24904
2022-07-31,WA,Grant,183,100,283,66683
2021-04-30,CA,San Francisco,1,1,2,89
2017-05-31,WA,Chelan,60,36,96,51875
2022-09-30,CA,Orange,5,2,7,313
2020-08-31,WA,Pend Oreille,0,0,0,5746
2017-12-31,WA,Spokane,297,240,537,300106
2019-10-31,WA,Mason,140,129,269,47564
2019-08-31,WA,Island,0,0,0,21275
2019-04-30,WA,Thurston,821,613,1434,196770
2017-01-31,WA,Franklin,27,42,69,55402
2018-03-31,WA,Pacific,15,18,33,15463
2018-03-31,WA,Klickitat,0,0,0,8045
2022-11-30,WA,Lincoln,0,0,0,4862
2023-04-30,WA,Chelan,605,154,759,54000
2020-06-30,WA,Pend Oreille,7,6,13,9243
2017-07-31,WA,Columbia,0,0,0,1533
2021-05-31,WA,Jefferson,0,0,0,9616
2018-07-31,WA,San Juan,149,62,211,14115
2017-03-31,WA,Okanogan,3,16,19,25642
2020-11-30,WA,Chelan,0,0,0,22778
2017-10-31,WA,Kittitas,33,23,56,28118
2021-03-31,WA,Whitman,0,0,0,8553
2019-05-31,WA,Klickitat,0,0,0,8237
2019-12-31,WA,Island,375,253,628,63608
2020-06-30,WA,Okanogan,0,0,0,16445
2022-12-31,WA,Ferry,0,0,0,3548
2017-04-30,CA,Ventura,0,1,1,362
2021-01-31,WA,Spokane,910,551,1461,320997
2020-04-30,WA,Chelan,224,80,304,54232
2021-02-28,CA,Los Angeles,10,10,20,917
2017-01-31,WA,Adams,0,0,0,5077
2017-10-31,WA,King,10942,4483,15425,1372199
2017-01-31,WA,Spokane,221,196,417,296020
2018-08-31,WA,Island,216,204,420,62724
2020-02-29,WA,San Juan,279,82,361,14330
2017-06-30,CA,Riverside,1,1,2,808
2021-12-31,CA,Contra Costa,1,4,5,260
2022-04-30,WA,Spokane,1511,810,2321,325760
2020-12-31,WA,Whatcom,1218,550,1768,150033
2018-04-30,WA,Kitsap,742,441,1183,177372
2021-06-30,WA,Clark,2841,1423,4264,322560
2020-07-31,WA,San Juan,0,0,0,5844
2023-04-30,WA,Clark,82,0,82,81044
2017-11-30,WA,Garfield,1,0,1,1313
2021-12-31,WA,Kitsap,0,0,0,54199
2020-09-30,WA,Chelan,260,80,340,54306
2020-04-30,CA,Alameda,3,1,4,277
2021-09-30,WA,Skamania,53,39,92,8385
2017-10-31,CA,Tulare,1,0,1,193
2020-01-31,CA,Tuolumne,0,1,1,11
2023-02-28,WA,King,50928,12806,63734,1330234
2018-12-31,WA,Lewis,0,0,0,25634
2019-01-31,CA,Santa Clara,8,1,9,370
2017-06-30,WA,Asotin,6,3,9,12427
2019-05-31,WA,Clallam,0,0,0,21746
2018-12-31,WA,Yakima,82,99,181,164762
2017-04-30,WA,Pacific,9,8,17,15082
2018-06-30,WA,Pend Oreille,0,0,0,5682
2018-01-31,CA,Riverside,1,2,3,731
2021-11-30,WA,Jefferson,0,0,0,9601
2018-01-31,WA,Okanogan,0,0,0,16333
2020-12-31,WA,Adams,0,0,0,5337
2020-07-31,CA,Shasta,1,0,1,38
2019-04-30,WA,Asotin,0,0,0,6629
2020-03-31,CA,Solano,1,0,1,212
2020-04-30,WA,Benton,0,0,0,42485
2019-04-30,WA,Spokane,1,0,1,94382
2020-06-30,WA,Jefferson,236,139,375,24797
2019-04-30,WA,Clallam,160,132,292,50458
2018-01-31,WA,Wahkiakum,0,0,0,1681
2023-01-31,WA,Lincoln,0,0,0,4853
2021-09-30,WA,Garfield,0,0,0,998
2017-01-31,WA,Grant,16,21,37,60386
2021-09-30,CA,Fresno,1,0,1,161
2019-02-28,WA,Wahkiakum,0,0,0,1720
2020-10-31,WA,Lewis,0,0,0,26496
2020-12-31,CA,Orange,4,3,7,446
2020-10-31,CA,Kern,0,1,1,219
2022-06-30,WA,King,66,1,67,180923
2021-04-30,WA,San Juan,406,125,531,14147
2020-05-31,CA,Orange,7,2,9,490
2023-01-31,CA,Santa Cruz,1,0,1,13
2019-04-30,WA,King,5,1,6,181820
2019-05-31,WA,Cowlitz,0,0,0,28843
2023-03-31,WA,Okanogan,3,0,3,16460
2018-06-30,WA,Kitsap,796,460,1256,178527
2022-03-31,WA,Lewis,226,164,390,59495
2019-12-31,CA,Ventura,0,3,3,299
2020-06-30,WA,Grays Harbor,106,111,217,48145
2022-11-30,WA,Yakima,410,218,628,166511
2017-12-31,WA,Island,155,165,320,61576
2020-06-30,WA,Walla Walla,0,0,0,13745
2020-08-31,WA,Okanogan,0,0,0,16543
2023-07-31,WA,Thurston,3153,1230,4383,185812
2020-02-29,WA,Clallam,1,0,1,21839
2018-10-31,WA,Thurston,663,552,1215,195071
2020-02-29,WA,Klickitat,49,41,90,15686
2022-01-31,WA,Adams,0,0,0,5434
2022-11-30,WA,San Juan,554,168,722,13981
2022-06-30,WA,Benton,751,461,1212,135364
2018-02-28,CA,Orange,3,1,4,572
2018-09-30,WA,Clallam,0,0,0,21492
2017-10-31,CA,San Diego,5,1,6,2612
2023-05-31,WA,Lewis,7,0,7,25864
2021-07-31,WA,Columbia,0,0,0,1555
2020-08-31,WA,Lewis,0,0,0,26362
2018-09-30,WA,King,14203,6079,20282,1373990
2019-02-28,WA,Klickitat,30,32,62,15450
2017-04-30,WA,Jefferson,0,0,0,9442
2023-07-31,WA,Garfield,0,3,3,1282
2023-01-31,WA,Thurston,2703,1144,3847,191970
2018-10-31,WA,Skamania,18,12,30,8728
2017-02-28,CA,Orange,2,1,3,676
2017-08-31,WA,Thurston,421,359,780,187775
2018-07-31,WA,Douglas,43,32,75,27719
2021-01-31,WA,Lincoln,0,0,0,4693
2022-08-31,WA,Stevens,76,56,132,30060
2018-12-31,WA,Benton,0,0,0,41561
2018-03-31,WA,San Juan,140,50,190,13939
2017-09-30,WA,Asotin,7,5,12,12463
2021-06-30,CA,Monterey,0,1,1,147
2017-03-31,WA,Chelan,0,0,0,21220
2018-05-31,WA,Cowlitz,58,75,133,71515
2018-10-31,WA,Walla Walla,0,0,0,13507
2020-07-31,WA,Kitsap,0,0,0,54144
2021-02-28,WA,Snohomish,1,0,1,125733
2020-11-30,WA,Clark,0,0,0,83228
2020-07-31,WA,Clark,2097,1066,3163,317956
2021-06-30,WA,Whitman,58,47,105,21996
2023-02-28,CA,Orange,7,2,9,286
2018-01-31,WA,Ferry,0,0,0,3544
2019-09-30,WA,Garfield,0,0,0,970
2019-03-31,WA,Spokane,1,0,1,94016
2022-06-30,WA,Asotin,0,0,0,6720
2021-03-31,WA,Lewis,0,0,0,26811
2019-03-31,CA,San Francisco,2,1,3,111
2020-02-29,WA,King,6,1,7,182612
2022-07-31,WA,Chelan,478,125,603,54238
2017-07-31,WA,Wahkiakum,0,2,2,2836
2022-08-31,WA,San Juan,5,0,5,5953
2021-02-28,CA,Kern,0,1,1,217
2021-09-30,CA,Kings,1,0,1,320
2022-08-31,WA,King,204,2,206,180057
2020-05-31,WA,Cowlitz,136,115,251,72360
2020-04-30,WA,Lewis,99,106,205,58652
2023-05-31,CA,Monterey,1,0,1,104
2021-02-28,WA,Adams,0,0,0,5344
2022-09-30,WA,San Juan,536,162,698,14006
2017-03-31,WA,Grays Harbor,27,26,53,44419
2021-05-31,WA,Grays Harbor,0,0,0,21430
2020-12-31,CA,El Dorado,1,0,1,33
2023-03-31,WA,Mason,403,200,603,46356
2022-12-31,WA,Pend Oreille,0,0,0,5582
2018-09-30,WA,Lincoln,0,0,0,4580
2018-04-30,WA,Stevens,10,24,34,31585
2019-07-31,WA,Chelan,0,0,0,22349
2018-01-31,WA,Skagit,1,0,1,31840
2017-10-31,WA,King,7,1,8,185856
2023-07-31,WA,Lewis,328,217,545,57742
2018-10-31,WA,Pierce,0,0,0,138782
2021-09-30,WA,Jefferson,358,186,544,24810
2017-09-30,CA,San Diego,6,1,7,2641
2018-02-28,WA,Grant,0,0,0,25680
2019-04-30,WA,Stevens,0,0,0,18683
2019-07-31,CA,Alameda,4,2,6,303
2021-10-31,WA,Thurston,1803,921,2724,197240
2018-06-30,WA,Whitman,19,28,47,22602
2021-02-28,WA,Kitsap,0,0,0,54278
2018-09-30,WA,Kitsap,1,0,1,53537
2020-07-31,CA,Riverside,3,1,4,610
2022-10-31,WA,Benton,867,485,1352,135773
2017-05-31,WA,San Juan,104,38,142,13498
2021-09-30,WA,Pend Oreille,17,7,24,9240
2023-02-28,WA,Okanogan,2,0,2,16449
2021-06-30,WA,Cowlitz,0,0,0,29122
2018-01-31,WA,Thurston,0,0,0,53893
2019-09-30,WA,Lincoln,2,10,12,7807
2020-05-31,WA,Klickitat,0,0,0,8121
2018-07-31,CA,San Diego,7,1,8,2569
2023-06-30,WA,Okanogan,7,0,7,16188
2020-08-31,WA,San Juan,0,0,0,5838
2019-06-30,CA,Orange,6,1,7,528
2019-11-30,WA,Grant,53,65,118,65498
2019-11-30,CA,Solano,1,0,1,204
2019-02-28,CA,Kern,0,1,1,233
2018-10-31,CA,Monterey,0,1,1,190
2018-01-31,WA,Grays Harbor,0,0,0,20089
2022-12-31,CA,Santa Barbara,1,0,1,65
2020-05-31,WA,Columbia,0,0,0,1523
2020-11-30,CA,Solano,1,0,1,206
2017-10-31,WA,Pend Oreille,0,0,0,5562
2018-09-30,WA,Benton,0,0,0,41347
2022-03-31,WA,Mason,0,0,0,21168
2017-12-31,WA,Snohomish,1,0,1,121405
2021-10-31,WA,Clallam,1,0,1,22063
2023-01-31,WA,Kittitas,312,94,406,29546
2021-06-30,CA,Alameda,3,0,3,236
2019-01-31,CA,Santa Cruz,1,0,1,42
2017-06-30,WA,Skamania,9,7,16,8566
2018-02-28,WA,Pacific,0,0,0,7561
2020-12-31,WA,Yakima,0,0,0,60982
2022-10-31,WA,Grant,210,108,318,66743
2022-11-30,WA,Clark,39,0,39,82070
2022-08-31,WA,Wahkiakum,24,12,36,3080
2018-01-31,CA,Alameda,0,1,1,358
2020-12-31,WA,Pierce,2825,1771,4596,555647
2022-11-30,WA,Kittitas,297,93,390,29569
2020-01-31,WA,Asotin,17,11,28,12723
2018-08-31,WA,Asotin,0,0,0,6649
2020-01-31,WA,Garfield,0,0,0,969
2018-04-30,WA,San Juan,0,0,0,5698
2017-11-30,WA,Benton,165,160,325,129883
2021-11-30,WA,Lincoln,7,16,23,7693
2022-04-30,CA,San Mateo,2,0,2,78
2022-12-31,WA,Skagit,11,0,11,32151
2022-12-31,WA,Wahkiakum,1,0,1,1790
2017-09-30,WA,Whatcom,496,190,686,143859
2018-04-30,WA,Kittitas,40,32,72,28774
2019-04-30,WA,Thurston,0,0,0,55024
2018-10-31,WA,Garfield,0,0,0,960
2017-10-31,WA,San Juan,127,40,167,13759
2020-02-29,WA,King,23446,7675,31121,1400298
2019-05-31,WA,Grays Harbor,0,0,0,20457
2017-04-30,WA,Yakima,38,54,92,159283
2022-10-31,WA,Asotin,26,19,45,12566
2019-08-31,CA,San Mateo,2,1,3,115
2018-03-31,WA,Kitsap,1,0,1,52964
2020-10-31,WA,Pacific,0,0,0,7752
2019-02-28,CA,Ventura,0,2,2,312
2021-11-30,WA,Asotin,21,17,38,12753
2017-12-31,WA,Cowlitz,54,67,121,70747
2017-11-30,WA,Lincoln,2,5,7,7552
2020-01-31,WA,Island,392,257,649,63598
2017-03-31,WA,Franklin,0,0,0,17960
2020-01-31,WA,Pacific,30,31,61,16096
2022-09-30,WA,Thurston,21,0,21,55058
2023-05-31,WA,Grays Harbor,6,0,6,20817
2017-12-31,WA,Kitsap,693,377,1070,175868
2020-11-30,WA,Clallam,1,0,1,21782
2020-04-30,WA,Pacific,0,0,0,7665
2021-06-30,WA,Adams,0,0,0,5386
2022-12-31,WA,Okanogan,97,52,149,26171
2022-03-31,CA,Sonoma,0,1,1,74
2017-02-28,WA,Walla Walla,0,0,0,13161
2022-01-31,WA,Yakima,0,0,0,61615
2022-06-30,WA,Asotin,23,19,42,12740
2019-04-30,WA,Adams,5,6,11,12657
2020-07-31,CA,Santa Cruz,1,0,1,31
2020-07-31,WA,Spokane,753,491,1244,316437
2022-10-31,WA,Clallam,456,256,712,49453
2017-06-30,WA,Wahkiakum,0,0,0,1644
2021-09-30,WA,Island,0,0,0,21574
2017-08-31,WA,Stevens,0,0,0,18218
2018-05-31,WA,Garfield,1,1,2,1326
2020-11-30,WA,Whitman,0,0,0,8487
2019-10-31,WA,Adams,0,0,0,5154
2021-01-31,CA,Monterey,0,1,1,150
2022-05-31,WA,Skamania,0,0,0,3971
2017-01-31,WA,Snohomish,1,0,1,122825
2017-09-30,WA,Thurston,435,363,798,188247
2018-09-30,WA,Pend Oreille,5,5,10,9589
2019-03-31,CA,Santa Clara,8,1,9,361
2020-01-31,CA,San Mateo,1,1,2,116
2019-10-31,WA,Yakima,115,114,229,165908
2017-02-28,CA,Los Angeles,3,1,4,1376
2023-07-31,WA,Klickitat,11,0,11,8015
2017-01-31,WA,Stevens,6,21,27,31528
2022-05-31,WA,Whitman,0,0,0,8562
2021-10-31,CA,Kings,2,0,2,322
2019-06-30,WA,Whitman,31,46,77,22712
2022-10-31,WA,Pierce,62,0,62,140244
2021-09-30,WA,Chelan,375,104,479,54762
2022-05-31,WA,Wahkiakum,22,10,32,3085
2022-09-30,WA,Lincoln,0,0,0,4853
2017-08-31,WA,Walla Walla,27,27,54,34981
2019-09-30,CA,Los Angeles,9,7,16,1087
2018-03-31,WA,Garfield,1,0,1,1330
2020-03-31,WA,Klickitat,0,0,0,8273
2017-05-31,WA,Spokane,1,0,1,90329
2020-05-31,CA,Santa Cruz,1,0,1,34
2019-05-31,WA,Asotin,0,0,0,6652
2020-05-31,WA,Garfield,0,0,0,967
2023-07-31,WA,Snohomish,13023,3087,16110,515187
2019-04-30,WA,Ferry,4,2,6,4370
2019-03-31,WA,Jefferson,0,0,0,9645
2018-05-31,WA,Jefferson,138,91,229,24389
2018-12-31,CA,Ventura,0,2,2,319
2021-12-31,CA,San Joaquin,1,1,2,94
2018-09-30,WA,Island,227,208,435,62869
2022-04-30,WA,Thurston,3,0,3,55595
2019-01-31,WA,Whatcom,2,0,2,42739
2017-03-31,WA,Whatcom,2,0,2,41393
2018-08-31,WA,Adams,5,5,10,12682
2022-08-31,WA,Skagit,855,348,1203,89814
2022-12-31,CA,Marin,0,1,1,29
2023-03-31,CA,Marin,0,1,1,27
2018-02-28,WA,Cowlitz,54,70,124,70938
2021-05-31,WA,Cowlitz,0,0,0,29142
2021-11-30,CA,Fresno,1,0,1,156
2019-06-30,CA,Los Angeles,8,5,13,1099
2021-01-31,WA,Garfield,0,2,2,1362
2020-08-31,WA,Franklin,66,77,143,60794
2023-07-31,WA,Spokane,2340,1124,3464,315617
2022-06-30,WA,Kittitas,1,0,1,14655
2019-02-28,WA,Columbia,0,0,0,1525
2019-02-28,WA,Clallam,153,127,280,50344
2018-07-31,CA,Alameda,0,1,1,343
2017-06-30,CA,Tuolumne,0,1,1,14
2019-02-28,CA,Riverside,2,2,4,657
2019-02-28,WA,Klickitat,0,0,0,8221
2023-01-31,CA,San Diego,17,9,26,1998
2021-04-30,WA,Adams,11,9,20,13054
2017-10-31,WA,Skamania,0,0,0,3892
2019-07-31,WA,Snohomish,3556,1617,5173,532742
2019-10-31,WA,Wahkiakum,4,3,7,3049
2021-07-31,WA,Skamania,51,36,87,8410
2019-12-31,CA,Fresno,1,0,1,188
2019-12-31,WA,Jefferson,217,134,351,25187
2017-08-31,WA,Jefferson,0,0,0,9427
2021-08-31,WA,King,32289,9551,41840,1365924
2023-05-31,WA,Thurston,57,0,57,53621
2018-01-31,WA,Kittitas,0,0,0,13876
2022-03-31,CA,Kings,2,1,3,305
2019-07-31,WA,Island,0,0,0,21312
2018-01-31,WA,Lewis,0,0,0,25325
2021-05-31,CA,San Mateo,1,0,1,102
2017-02-28,WA,Pend Oreille,1,4,5,9300
2019-11-30,WA,Garfield,0,1,1,1304
2018-10-31,WA,Pend Oreille,6,5,11,9588
2019-02-28,CA,Los Angeles,6,5,11,1086
2021-06-30,WA,San Juan,0,0,0,5942
2020-10-31,WA,Thurston,1254,761,2015,197304
2022-01-31,WA,Skagit,701,307,1008,90876
2017-05-31,WA,Walla Walla,23,24,47,34853
2020-02-29,WA,Pacific,30,32,62,16071
2019-11-30,WA,Lewis,0,0,0,26110
2017-09-30,WA,Yakima,0,0,0,57707
2017-09-30,WA,Island,0,0,0,20564
2019-03-31,WA,Lincoln,0,0,0,4683
2020-12-31,WA,Garfield,0,0,0,996
2021-10-31,WA,Pacific,49,59,108,16114
2018-07-31,WA,Skamania,13,9,22,8635
2018-12-31,WA,Pierce,0,0,0,139122
2018-11-30,WA,Stevens,0,0,0,18731
2020-07-31,WA,Skamania,31,20,51,8428
2020-07-31,CA,Ventura,1,2,3,278
2023-02-28,WA,Jefferson,9,0,9,9332
2017-07-31,WA,Benton,155,148,303,128671
2020-11-30,WA,Lewis,117,117,234,58633
2022-08-31,WA,Asotin,24,18,42,12617
2022-07-31,WA,San Juan,521,160,681,14025
2019-12-31,WA,Adams,6,7,13,12936
2021-04-30,WA,Ferry,10,3,13,4406
2019-05-31,WA,Garfield,0,0,0,954
2017-05-31,WA,Cowlitz,0,0,0,27873
2022-01-31,WA,Clallam,1,0,1,22143
2017-08-31,WA,Kittitas,0,0,0,13610
2019-06-30,WA,Grays Harbor,73,85,158,47923
2020-06-30,WA,Thurston,0,0,0,55742
2019-09-30,WA,Grays Harbor,0,0,0,20636
2021-02-28,WA,Kittitas,0,0,0,14694
2017-07-31,WA,Spokane,1,0,1,90744
2020-11-30,WA,Cowlitz,170,124,294,72016
2017-09-30,WA,Benton,0,0,0,40273
2022-12-31,WA,Thurston,38,0,38,54686
2017-02-28,WA,Douglas,0,0,0,11387
2018-11-30,WA,Pend Oreille,0,0,0,5742
2017-11-30,WA,Whitman,16,19,35,22387
2017-09-30,CA,Santa Clara,5,2,7,388
2021-09-30,WA,Pierce,3877,2069,5946,559042
2019-11-30,WA,Thurston,1035,700,1735,199127
2019-07-31,WA,Franklin,53,71,124,60145
2017-04-30,CA,Orange,2,1,3,646
2021-01-31,WA,Douglas,0,0,0,12505
2017-10-31,WA,Whitman,0,0,0,8440
2022-07-31,WA,Kittitas,1,0,1,14616
2019-11-30,WA,King,21598,7457,29055,1395552
2017-08-31,WA,Pierce,999,866,1865,524926
2017-05-31,WA,Whitman,10,20,30,21988
2021-03-31,WA,Jefferson,302,174,476,24829
2020-12-31,WA,Skagit,1,0,1,32781
2021-05-31,WA,Pend Oreille,14,6,20,9275
2022-03-31,WA,Columbia,0,0,0,1589
2022-01-31,CA,Marin,0,1,1,31
2020-05-31,WA,Whitman,45,48,93,22175
2020-11-30,WA,Jefferson,0,0,0,9582
2020-08-31,WA,Spokane,781,505,1286,317481
2021-01-31,CA,Alameda,3,0,3,259
2023-07-31,WA,Island,33,0,33,20607
2020-10-31,WA,Yakima,0,0,0,60694
2017-09-30,WA,Snohomish,1,0,1,121526
2021-09-30,WA,Skamania,0,0,0,4043
2019-10-31,WA,Jefferson,210,126,336,25159
2022-05-31,CA,Orange,5,2,7,351
2020-02-29,WA,Stevens,0,0,0,18756
2019-08-31,WA,Island,335,244,579,63461
2020-06-30,WA,Jefferson,0,0,0,9533
2018-05-31,CA,Marin,1,0,1,56
2017-06-30,CA,Los Angeles,3,1,4,1294
2022-03-31,CA,Placer,2,0,2,69
2022-03-31,CA,Contra Costa,0,3,3,252
2023-07-31,WA,Benton,1158,568,1726,131666
2019-11-30,CA,Los Angeles,8,9,17,1065
2022-05-31,CA,Monterey,1,1,2,126
2019-10-31,CA,San Francisco,2,1,3,100
2018-09-30,WA,Ferry,2,2,4,4406
2021-02-28,WA,Stevens,38,42,80,30228
2023-03-31,CA,Orange,7,2,9,276
2017-08-31,WA,Spokane,268,220,488,297411
2022-04-30,WA,Lincoln,7,18,25,7670
2018-01-31,WA,Ferry,1,3,4,4408
2019-06-30,WA,Clark,1538,926,2464,313856
2018-05-31,WA,San Juan,0,0,0,5702
2020-08-31,CA,Riverside,3,0,3,609
2019-04-30,CA,Santa Cruz,1,0,1,39
2018-02-28,WA,Clark,0,0,0,78570
2021-08-31,WA,Yakima,248,163,411,168910
2020-01-31,WA,Franklin,57,76,133,61093
2020-03-31,WA,Skamania,29,18,47,8716
2019-11-30,CA,Contra Costa,3,2,5,349
2019-02-28,WA,Thurston,782,594,1376,195890
2021-12-31,WA,Grays Harbor,192,157,349,49447
2019-06-30,WA,Clallam,173,141,314,50501
2021-01-31,WA,Stevens,37,40,77,30273
2018-10-31,WA,Whatcom,2,0,2,42555
2020-04-30,WA,Clallam,1,0,1,21696
2019-10-31,WA,King,21367,7391,28758,1396136
2018-06-30,WA,Pend Oreille,5,5,10,9547
2022-04-30,WA,Lewis,232,171,403,59518
2019-03-31,WA,Thurston,0,0,0,54948
2019-03-31,WA,Klickitat,32,31,63,15424
2022-04-30,CA,Santa Clara,9,1,10,217
2018-04-30,WA,Grant,31,42,73,62794
2021-03-31,CA,Placer,2,0,2,79
2020-01-31,WA,Yakima,0,0,0,59638
2018-04-30,WA,Kitsap,1,0,1,52991
2021-03-31,WA,Wahkiakum,0,0,0,1788
2020-02-29,WA,Island,401,263,664,63475
2019-11-30,WA,Columbia,3,2,5,2443
2018-04-30,WA,Clallam,0,0,0,21359
2017-09-30,WA,Chelan,75,37,112,52503
2017-01-31,WA,Skagit,106,81,187,87447
2020-08-31,WA,Snohomish,0,0,0,124595
2017-06-30,WA,Grant,0,0,0,25220
2021-02-28,WA,Pacific,0,0,0,7828
2017-01-31,WA,Ferry,0,0,0,3581
2018-02-28,WA,Klickitat,24,27,51,14944
2020-10-31,CA,Sacramento,1,0,1,243
2017-02-28,WA,Okanogan,3,15,18,25674
2017-10-31,WA,Kittitas,0,0,0,13695
2018-03-31,WA,Spokane,1,0,1,91900
2021-12-31,WA,Garfield,0,0,0,1001
2018-09-30,CA,Contra Costa,0,2,2,423
2022-06-30,WA,Pend Oreille,0,0,0,5670
2021-10-31,WA,Clallam,365,235,600,50522
2021-03-31,WA,Franklin,100,88,188,61668
2017-05-31,CA,San Mateo,0,1,1,157
2022-02-28,WA,Pierce,2,0,2,144061
2022-11-30,WA,Cowlitz,4,0,4,28412
2023-04-30,WA,Ferry,0,0,0,3556
2019-03-31,WA,King,17678,6779,24457,1381383
2017-01-31,CA,Orange,2,1,3,704
2021-02-28,WA,Skagit,1,0,1,32853
2020-09-30,WA,Thurston,1211,753,1964,197219
2021-10-31,WA,Whitman,63,58,121,21932
2022-05-31,CA,Kern,0,1,1,188
2020-10-31,CA,Solano,1,0,1,205
2023-06-30,WA,Columbia,0,0,0,1535
2021-10-31,WA,Garfield,0,0,0,999
2017-11-30,WA,Lewis,53,39,92,56418
2017-05-31,CA,Riverside,1,1,2,821
2020-02-29,WA,Mason,0,0,0,20602
2022-02-28,WA,Okanogan,74,47,121,26474
2020-03-31,WA,Grays Harbor,107,109,216,48321
2020-09-30,WA,Stevens,35,38,73,30417
2019-12-31,WA,Douglas,0,0,0,12308
2021-04-30,CA,San Joaquin,1,0,1,105
2023-05-31,CA,Sonoma,1,1,2,50
2022-04-30,WA,Chelan,447,124,571,54522
2022-05-31,CA,San Mateo,2,0,2,79
2021-01-31,WA,Grant,87,84,171,66105
2020-07-31,WA,Island,1,0,1,21235
2019-03-31,WA,Skagit,281,189,470,91327
2019-09-30,WA,San Juan,0,0,0,5916
2021-11-30,WA,Douglas,0,0,0,12693
2019-01-31,WA,Skamania,18,15,33,8741
2018-05-31,WA,Spokane,1,0,1,92371
2019-05-31,WA,Columbia,0,0,0,1532
2017-08-31,WA,Skagit,140,112,252,88466
2018-04-30,WA,Whitman,20,24,44,22555
2019-05-31,CA,San Mateo,2,1,3,123
2018-10-31,WA,Douglas,0,0,0,12077
2021-11-30,CA,Monterey,0,1,1,137
2021-05-31,WA,Ferry,0,0,0,3661
2020-03-31,WA,Kittitas,0,0,0,14621
2020-02-29,WA,Lincoln,0,0,0,4658
2020-08-31,WA,Grant,0,0,0,27237
2021-09-30,WA,Garfield,0,3,3,1366
2019-09-30,WA,Chelan,0,0,0,22420
2021-01-31,WA,San Juan,0,0,0,5867
2022-06-30,WA,King,40732,11318,52050,1349910
2020-06-30,CA,San Mateo,0,1,1,110
2021-01-31,WA,Skagit,517,243,760,91439
2019-07-31,WA,Kitsap,1,0,1,54128
2020-07-31,WA,Franklin,0,0,0,20096
2021-04-30,WA,Island,582,308,890,63254
2023-06-30,WA,Jefferson,560,258,818,24060
2020-04-30,WA,Island,405,270,675,62863
2023-07-31,WA,Mason,462,212,674,45044
2022-11-30,WA,Skagit,908,352,1260,89513
2017-12-31,WA,Asotin,8,5,13,12519
2022-02-28,WA,Franklin,0,0,0,20925
2022-09-30,CA,Contra Costa,0,3,3,222
2017-01-31,WA,San Juan,0,0,0,5594
2019-09-30,CA,Fresno,1,0,1,194
2019-03-31,CA,Orange,5,1,6,532
2023-07-31,WA,Garfield,0,0,0,950
2019-02-28,WA,Walla Walla,0,0,0,13543
2020-02-29,WA,Whatcom,3,0,3,43146
2020-06-30,WA,Whatcom,3,0,3,43006
2020-01-31,WA,Ferry,5,2,7,4381
2022-12-31,WA,Asotin,29,20,49,12492
2022-06-30,WA,Pacific,0,0,0,7916
2020-12-31,WA,Snohomish,5036,1848,6884,538610
2023-01-31,WA,Whitman,3,0,3,8648
2018-08-31,WA,Asotin,11,8,19,12663
2023-02-28,CA,Ventura,2,1,3,200
2020-05-31,WA,Clark,0,0,0,81892
2020-01-31,WA,Clallam,203,163,366,50913
2018-02-28,WA,Douglas,43,33,76,27316
2021-03-31,WA,Douglas,86,47,133,28378
2021-06-30,WA,Adams,16,11,27,13035
2018-11-30,WA,Skagit,1,0,1,32338
2019-12-31,WA,Okanogan,30,30,60,26236
2018-04-30,WA,Whitman,0,0,0,8463
2022-09-30,WA,Franklin,2,0,2,20933
2018-04-30,WA,Island,0,0,0,20845
2023-05-31,WA,Pierce,152,0,152,136292
2018-12-31,WA,Grant,0,0,0,26258
2018-05-31,WA,Jefferson,0,0,0,9539
2022-09-30,WA,Ferry,0,0,0,3616
2023-01-31,WA,Okanogan,105,53,158,26127
2018-07-31,WA,Pend Oreille,5,5,10,9578
2017-10-31,WA,Walla Walla,0,0,0,13256
2018-07-31,CA,Santa Clara,7,0,7,372
2021-07-31,WA,King,5,1,6,184354
2019-07-31,WA,Lewis,100,96,196,59368
2023-06-30,CA,Riverside,6,0,6,337
2018-05-31,WA,Asotin,8,6,14,12602
2022-03-31,WA,Stevens,0,0,0,19002
2019-02-28,WA,Clark,0,0,0,79977
2021-11-30,WA,Franklin,0,0,0,20782
2018-08-31,WA,Klickitat,24,32,56,15283
2023-04-30,WA,Skagit,1055,389,1444,88585
2018-08-31,WA,Skagit,220,169,389,90837
2019-02-28,WA,Walla Walla,43,54,97,36066
2018-02-28,WA,Mason,64,80,144,45049
2019-09-30,WA,Whitman,0,0,0,8604
2021-10-31,WA,Columbia,0,0,0,1537
2018-04-30,WA,Asotin,8,6,14,12640
2020-08-31,WA,Asotin,17,14,31,12356
2019-02-28,CA,Santa Cruz,1,0,1,41
2022-10-31,CA,Napa,0,1,1,10
2020-03-31,WA,Whitman,0,0,0,8549
2020-04-30,WA,Franklin,0,0,0,19844
2017-10-31,CA,Orange,3,1,4,600
2019-06-30,WA,Grant,0,0,0,26631
2018-05-31,WA,Clallam,0,0,0,21412
2019-08-31,CA,Shasta,1,0,1,40
2023-05-31,WA,Franklin,300,136,436,61492
2022-04-30,WA,Kitsap,2325,1020,3345,179074
2022-12-31,WA,King,48110,12252,60362,1337864
2021-04-30,CA,Monterey,0,1,1,147
2022-04-30,WA,Lincoln,0,0,0,4851
2017-04-30,WA,Walla Walla,0,0,0,13177
2021-11-30,CA,Solano,1,0,1,175
2018-06-30,CA,Riverside,2,2,4,699
2023-03-31,WA,Pacific,3,0,3,7805
2023-02-28,WA,Jefferson,508,242,750,24237
2023-01-31,WA,Okanogan,2,0,2,16435
2023-04-30,WA,Grant,10,0,10,27865
2018-04-30,CA,San Francisco,0,1,1,133
2017-02-28,WA,Snohomish,1604,824,2428,514072
2023-03-31,WA,San Juan,596,172,768,13839
2020-08-31,CA,Los Angeles,8,11,19,981
2022-10-31,CA,San Bernardino,1,1,2,291
2017-01-31,WA,Kittitas,15,16,31,27158
2021-02-28,WA,Clallam,282,195,477,49992
2020-02-29,CA,Solano,1,0,1,211
2017-03-31,WA,Asotin,5,2,7,12335
2022-08-31,WA,Clallam,4,0,4,21879
2019-09-30,WA,San Juan,229,73,302,14431
2017-02-28,WA,Chelan,55,29,84,51755
2021-05-31,CA,Los Angeles,10,11,21,891
2022-08-31,CA,Alameda,4,0,4,174
2021-06-30,WA,Pierce,3470,1997,5467,560461
2017-03-31,WA,Benton,0,0,0,39849
2018-05-31,WA,Pacific,0,0,0,7588
2021-10-31,CA,San Joaquin,1,1,2,96
2023-04-30,WA,San Juan,605,173,778,13782
2021-07-31,CA,Riverside,5,1,6,537
2020-02-29,WA,Adams,0,0,0,5221
2022-04-30,WA,Skagit,752,328,1080,90318
2021-07-31,WA,Garfield,0,3,3,1375
2021-03-31,CA,San Joaquin,1,0,1,104
2018-12-31,WA,Ferry,3,2,5,4383
2023-02-28,WA,Pend Oreille,0,0,0,5573
2019-07-31,WA,Grant,0,0,0,26703
2017-07-31,WA,Wahkiakum,0,0,0,1659
2023-02-28,WA,Walla Walla,3,0,3,13814
2022-02-28,WA,Jefferson,394,202,596,24685
2019-04-30,CA,Tuolumne,0,1,1,12
2017-02-28,WA,Lewis,0,0,0,24783
2020-09-30,WA,Jefferson,0,0,0,9541
2019-07-31,WA,Franklin,0,0,0,19368
2023-01-31,WA,Grays Harbor,2,0,2,21070
2021-08-31,WA,Skagit,1,0,1,32973
2022-08-31,WA,Franklin,2,0,2,20905
2023-05-31,WA,Garfield,1,3,4,1303
2018-04-30,CA,Marin,1,0,1,56
2022-04-30,WA,Jefferson,415,210,625,24734
2022-08-31,CA,San Mateo,1,0,1,70
2021-10-31,CA,Kern,0,1,1,196
2022-04-30,CA,San Bernardino,1,1,2,335
2019-02-28,WA,San Juan,0,0,0,5799
2022-11-30,WA,Pend Oreille,0,0,0,5602
2017-08-31,WA,Benton,161,147,308,129043
2018-05-31,WA,Grant,30,44,74,63010
2018-02-28,WA,Benton,0,0,0,40752
2022-08-31,WA,Skamania,0,0,0,3906
2020-01-31,WA,San Juan,0,0,0,5928
2019-08-31,WA,Clallam,184,148,332,50729
2022-10-31,WA,Kitsap,2634,1125,3759,177642
2020-11-30,WA,Grays Harbor,122,117,239,48546
2017-02-28,CA,Marin,1,0,1,59
2019-10-31,WA,San Juan,236,76,312,14410
2019-12-31,WA,Skamania,0,0,0,4099
2017-03-31,WA,Garfield,0,0,0,940
2018-07-31,WA,Mason,0,0,0,20051
2021-01-31,WA,Clark,2459,1211,3670,319410
2021-06-30,WA,Lewis,0,0,0,26859
2022-11-30,CA,Monterey,1,1,2,119
2022-02-28,WA,Ferry,15,3,18,4443
2019-10-31,WA,Pacific,0,0,0,7726
2018-09-30,WA,Okanogan,10,20,30,26057
2017-12-31,WA,Adams,4,5,9,12408
2019-01-31,WA,Jefferson,175,112,287,24852
2017-08-31,WA,Adams,0,0,0,5097
2019-10-31,WA,Kittitas,0,0,0,14618
2017-03-31,WA,Thurston,365,313,678,185430
2022-06-30,WA,Skamania,0,0,0,3971
2021-01-31,WA,Pend Oreille,0,0,0,5717
2018-05-31,WA,Chelan,0,0,0,21823
2019-04-30,WA,Benton,0,0,0,41655
2019-02-28,WA,Pacific,0,0,0,7634
2022-11-30,WA,Adams,1,0,1,5396
2023-05-31,CA,Los Angeles,4,4,8,565
2022-03-31,CA,Alameda,4,0,4,196
2018-08-31,WA,Skamania,0,0,0,3948
2020-11-30,WA,Franklin,0,0,0,20378
2021-12-31,WA,Snohomish,2,0,2,125446
2021-02-28,WA,Spokane,0,0,0,101004
2017-12-31,WA,Benton,0,0,0,40573
2022-02-28,WA,Whitman,0,0,0,8578
2023-06-30,WA,Snohomish,173,0,173,119726
2019-06-30,WA,Clallam,1,0,1,21740
2021-04-30,WA,Cowlitz,211,134,345,72518
2021-01-31,WA,Benton,453,358,811,135157
2021-02-28,WA,Asotin,17,14,31,12486
2018-11-30,WA,Grays Harbor,0,0,0,20338
2022-12-31,WA,Benton,10,0,10,43344
2019-11-30,WA,Garfield,0,0,0,965
2021-01-31,WA,Kittitas,0,0,0,14675
2019-09-30,WA,Clallam,185,151,336,50854
2020-08-31,WA,Pacific,32,33,65,15709
2021-05-31,WA,Garfield,0,0,0,999
2022-03-31,WA,King,37937,10707,48644,1352308
2019-01-31,WA,Kitsap,981,556,1537,179937
2022-10-31,WA,Yakima,5,0,5,61277
2022-08-31,CA,Orange,6,2,8,321
2021-07-31,WA,Clallam,1,0,1,22036
2022-12-31,WA,Adams,1,0,1,5387
2022-01-31,WA,Lewis,0,0,0,26654
2022-10-31,WA,Spokane,1837,910,2747,324785
2018-01-31,CA,Sacramento,1,0,1,303
2020-09-30,WA,Spokane,1,0,1,99865
2018-08-31,WA,Skamania,14,10,24,8670
2020-10-31,WA,Chelan,0,0,0,22770
2023-05-31,WA,Island,29,0,29,20927
2019-11-30,WA,Clark,1806,1025,2831,317525
2022-02-28,WA,Whitman,70,56,126,22020
2023-04-30,WA,Lincoln,18,16,34,7641
2018-10-31,WA,Adams,5,5,10,12720
2020-06-30,WA,Pacific,0,0,0,7699
2020-05-31,WA,Clallam,222,165,387,50115
2019-08-31,WA,Walla Walla,56,63,119,36230
2017-11-30,WA,Lincoln,0,0,0,4484
2020-08-31,WA,Benton,380,322,702,134321
2021-08-31,CA,San Joaquin,1,0,1,100
2022-06-30,WA,Kittitas,266,83,349,29763
2020-10-31,WA,Lincoln,0,0,0,4661
2022-07-31,CA,Ventura,2,1,3,222
2021-10-31,CA,San Luis Obispo,1,0,1,58
2022-07-31,WA,Thurston,8,0,8,55356
2019-10-31,CA,Contra Costa,2,2,4,356
2022-07-31,WA,Columbia,7,0,7,2430
2020-07-31,CA,San Mateo,0,1,1,108
2022-05-31,WA,Whatcom,1799,729,2528,148935
2021-07-31,WA,Kittitas,166,68,234,29980
2019-05-31,CA,Contra Costa,2,2,4,383
2020-09-30,CA,San Mateo,0,1,1,105
2019-04-30,WA,Lincoln,0,0,0,4700
2018-03-31,WA,Grant,0,0,0,25746
2020-09-30,WA,Chelan,0,0,0,22729
2019-11-30,CA,Fresno,1,0,1,190
2023-01-31,WA,Snohomish,10586,2793,13379,530262
2019-08-31,WA,Columbia,2,2,4,2455
2020-02-29,WA,Thurston,0,0,0,55720
2019-06-30,WA,San Juan,0,0,0,5866
2023-07-31,CA,Placer,1,0,1,49
2019-08-31,WA,Kitsap,1114,633,1747,181513
2022-05-31,CA,Riverside,8,1,9,462
2018-09-30,WA,Douglas,48,33,81,27849
2017-01-31,WA,Asotin,0,0,0,6487
2021-11-30,WA,Garfield,0,0,0,995
2019-05-31,WA,Whitman,31,45,76,22710
2021-02-28,WA,Lincoln,6,13,19,7648
2022-09-30,WA,Chelan,6,0,6,23093
2021-08-31,CA,Monterey,0,1,1,144
2023-05-31,WA,Cowlitz,8,0,8,28004
2017-04-30,WA,Chelan,0,0,0,21208
2021-04-30,WA,Clallam,309,206,515,50403
2022-08-31,WA,Cowlitz,353,172,525,70460
2019-06-30,WA,Okanogan,0,0,0,16482
2023-03-31,WA,Chelan,582,150,732,54135
2019-01-31,WA,Thurston,771,590,1361,196046
2022-01-31,WA,Adams,17,14,31,13041
2018-07-31,WA,Mason,87,93,180,45864
2020-01-31,WA,Skamania,0,0,0,4106
2022-09-30,WA,Snohomish,9066,2624,11690,531280
2017-06-30,WA,Lincoln,0,0,0,4429
2017-10-31,WA,Yakima,57,72,129,161008
2019-08-31,WA,Stevens,0,0,0,18717
2019-04-30,CA,Riverside,2,2,4,663
2020-12-31,WA,Island,0,0,0,21369
2018-01-31,WA,King,8,1,9,184806
2020-01-31,CA,Shasta,1,0,1,35
2022-07-31,CA,San Diego,16,11,27,2199
2022-03-31,WA,Snohomish,7665,2362,10027,534917
2021-04-30,WA,Mason,191,134,325,48096
2023-02-28,WA,Mason,9,0,9,20863
2017-05-31,WA,Franklin,0,0,0,18090
2019-07-31,WA,Adams,5,6,11,12835
2019-03-31,WA,Whitman,0,0,0,8502
2022-10-31,CA,Los Angeles,6,6,12,685
2018-05-31,WA,Island,187,177,364,62446
2019-11-30,WA,Lincoln,1,11,12,7798
2018-02-28,WA,Okanogan,0,0,0,16305
2021-12-31,WA,San Juan,0,0,0,6002
2019-12-31,CA,Alameda,5,1,6,292
2020-12-31,WA,Cowlitz,0,0,0,28933
2019-12-31,WA,Grays Harbor,105,100,205,48394
2020-03-31,WA,Douglas,71,40,111,28174
2018-08-31,WA,Grays Harbor,54,65,119,46989
2022-06-30,WA,Okanogan,83,50,133,26390
2022-08-31,WA,Mason,330,177,507,47021
2018-07-31,CA,Ventura,0,2,2,312
2022-11-30,CA,Kern,1,1,2,188
2018-03-31,WA,Jefferson,0,0,0,9515
2023-02-28,WA,Clallam,12,0,12,21812
2020-04-30,WA,Wahkiakum,0,0,0,1760
2018-09-30,CA,Alameda,0,2,2,333
2017-05-31,WA,Clark,770,489,1259,298797
2018-01-31,CA,San Diego,6,1,7,2567
2021-08-31,WA,Ferry,9,3,12,4389
2023-01-31,WA,Mason,380,192,572,46777
2023-05-31,CA,Alameda,3,0,3,147
2023-02-28,WA,Benton,989,517,1506,135708
2020-08-31,WA,Stevens,0,0,0,18653
2023-07-31,WA,Pacific,4,0,4,7654
2018-07-31,WA,Stevens,0,0,0,18650
2018-06-30,CA,San Mateo,1,1,2,131
2022-05-31,WA,Thurston,2127,1028,3155,194514
2020-11-30,WA,Walla Walla,0,0,0,13819
2017-02-28,WA,Garfield,0,0,0,934
2017-07-31,WA,Okanogan,0,0,0,16226
2017-12-31,WA,Clark,851,573,1424,304270
2019-05-31,WA,Lewis,0,0,0,25915
2020-03-31,WA,Benton,344,319,663,135166
2020-08-31,CA,Shasta,1,0,1,36
2019-06-30,WA,Jefferson,197,119,316,24995
2023-06-30,WA,Columbia,11,1,12,2395
2022-06-30,WA,Chelan,461,126,587,54351
2021-08-31,WA,Thurston,1715,906,2621,197780
2021-01-31,WA,Thurston,1350,796,2146,197459
2023-03-31,WA,Garfield,1,3,4,1323
2023-05-31,WA,Okanogan,123,62,185,25949
2020-02-29,WA,Kittitas,94,49,143,30014
2017-05-31,WA,Kittitas,0,0,0,13532
2020-07-31,WA,Stevens,0,0,0,18672
2017-02-28,WA,Columbia,0,0,0,1528
2021-09-30,WA,Franklin,0,0,0,20718
2019-12-31,WA,Yakima,116,114,230,166298
2022-03-31,WA,Lincoln,7,18,25,7668
2022-01-31,CA,Los Angeles,10,7,17,817
2018-03-31,WA,Snohomish,1,0,1,121231
2022-11-30,WA,Walla Walla,201,108,309,35703
2021-05-31,WA,Franklin,0,0,0,20653
2022-06-30,WA,Spokane,1602,848,2450,325470
2018-01-31,WA,Clark,873,599,1472,305301
2020-08-31,WA,Thurston,0,0,0,55974
2022-01-31,WA,Jefferson,0,0,0,9571
2018-03-31,WA,San Juan,0,0,0,5658
2022-11-30,WA,Thurston,2552,1116,3668,192629
2020-10-31,WA,Kitsap,1465,730,2195,179705
2019-04-30,CA,Contra Costa,2,2,4,389
2023-05-31,WA,Snohomish,162,0,162,120661
2017-07-31,WA,Island,121,141,262,60273
2021-05-31,WA,Lewis,0,0,0,26895
2021-10-31,WA,Wahkiakum,0,0,0,1827
2022-03-31,WA,Island,758,360,1118,62387
2019-05-31,WA,Skagit,1,0,1,32417
2020-07-31,CA,San Joaquin,1,0,1,125
2022-08-31,WA,Thurston,2326,1086,3412,193178
2022-01-31,WA,Pend Oreille,17,9,26,9118
2022-03-31,WA,Ferry,17,3,20,4431
2021-10-31,WA,San Juan,0,0,0,5976
2018-01-31,CA,Contra Costa,0,1,1,469
2017-06-30,CA,Ventura,0,1,1,356
2020-04-30,WA,Skamania,0,0,0,4054
2019-12-31,WA,Klickitat,0,0,0,8318
2017-01-31,WA,Pacific,0,0,0,7509
2020-04-30,WA,Grays Harbor,0,0,0,20728
2022-09-30,WA,Benton,5,0,5,43402
2019-03-31,WA,Adams,0,0,0,5105
2020-01-31,WA,Pierce,0,0,0,141347
2021-09-30,WA,Grant,0,0,0,28010
2021-10-31,WA,Pierce,0,0,0,145249
2018-03-31,WA,Grays Harbor,0,0,0,20078
2020-05-31,WA,Spokane,721,479,1200,315019
2017-11-30,WA,Okanogan,0,0,0,16273
2017-09-30,WA,Mason,61,73,134,44172
2021-08-31,WA,Grant,123,96,219,66857
2021-09-30,WA,Douglas,0,0,0,12713
2020-02-29,WA,Wahkiakum,5,5,10,3017
2022-07-31,WA,Pacific,64,71,135,15841
2021-04-30,WA,Klickitat,67,47,114,15186
2017-12-31,WA,Adams,0,0,0,5128
2019-05-31,WA,Yakima,0,0,0,59084
2017-11-30,CA,Tulare,1,0,1,189
2021-08-31,WA,San Juan,452,141,593,14207
2022-03-31,WA,Clallam,402,240,642,49973
2022-05-31,WA,Lewis,0,0,0,26423
2018-12-31,WA,Spokane,1,0,1,93762
2020-02-29,WA,Pend Oreille,0,0,0,5763
2023-06-30,CA,Kings,2,1,3,246
2020-01-31,WA,Benton,0,0,0,42555
2020-12-31,WA,Pacific,34,35,69,15727
2022-06-30,CA,Contra Costa,0,4,4,241
2018-01-31,WA,Adams,4,4,8,12443
2018-03-31,WA,Asotin,0,0,0,6593
2019-03-31,WA,Whatcom,792,386,1178,149745
2017-03-31,WA,Clark,718,454,1172,298270
2023-06-30,WA,Pierce,7556,2770,10326,524039
2020-03-31,WA,Asotin,16,12,28,12596
2023-03-31,CA,Santa Clara,8,2,10,151
2017-05-31,WA,Grant,20,25,45,60675
2019-10-31,WA,Garfield,0,1,1,1301
2018-12-31,WA,Asotin,0,0,0,6635
2020-05-31,WA,Thurston,0,0,0,55495
2018-02-28,CA,Monterey,0,2,2,194
2022-12-31,WA,San Juan,8,0,8,5913
2017-04-30,WA,Grant,18,21,39,60489
2021-06-30,WA,Mason,215,140,355,48176
2020-08-31,CA,Contra Costa,4,3,7,302
2023-07-31,CA,Napa,0,1,1,8
2020-09-30,CA,Riverside,3,0,3,607
2019-02-28,WA,Kitsap,1,0,1,53701
2017-09-30,WA,Lewis,0,0,0,25113
2021-02-28,WA,Pend Oreille,0,0,0,5722
2023-02-28,WA,Grant,7,0,7,28056
2021-11-30,CA,Ventura,2,1,3,246
2022-06-30,WA,Grant,0,0,0,28025
2018-08-31,WA,Snohomish,1,0,1,121713
2018-03-31,WA,Grant,32,42,74,62599
2017-10-31,WA,Spokane,1,0,1,91331
2023-02-28,WA,Lincoln,16,17,33,7744
2020-01-31,WA,Lewis,109,104,213,59601
2019-09-30,WA,Walla Walla,0,0,0,13687
2017-07-31,WA,Yakima,49,62,111,159655
2020-03-31,WA,Pacific,29,34,63,16025
2022-09-30,WA,Skamania,85,51,136,8126
2023-03-31,WA,Lewis,5,0,5,26061
2020-08-31,WA,Klickitat,57,42,99,15043
2017-08-31,CA,Orange,3,1,4,611
2021-11-30,WA,Pend Oreille,18,7,25,9167
2018-10-31,CA,Contra Costa,0,2,2,419
2021-02-28,CA,Contra Costa,3,3,6,279
2018-01-31,WA,Pend Oreille,0,0,0,5618
2018-10-31,WA,Grays Harbor,60,66,126,47272
2020-11-30,WA,Ferry,8,3,11,4347
2019-11-30,WA,Skagit,1,0,1,32541
2019-09-30,WA,Yakima,111,113,224,165657
2023-04-30,WA,Grant,265,114,379,66651
2017-06-30,WA,San Juan,0,0,0,5535
2020-08-31,WA,Kitsap,0,0,0,54174
2017-10-31,WA,Stevens,9,22,31,31532
2017-04-30,WA,Whitman,0,0,0,8380
2021-01-31,CA,San Mateo,1,1,2,106
2020-06-30,WA,Whatcom,1064,498,1562,149248
2017-02-28,WA,Pierce,0,0,0,138554
2020-09-30,WA,Douglas,0,0,0,12380
2018-02-28,WA,Thurston,0,0,0,53921
2020-08-31,WA,Kittitas,0,0,0,14559
2021-09-30,WA,Lincoln,0,0,0,4784
2020-09-30,WA,Pierce,2575,1710,4285,553881
2020-02-29,WA,Ferry,5,2,7,4373
2021-09-30,WA,Clark,0,0,0,84157
2023-01-31,WA,Garfield,0,0,0,976
2021-04-30,WA,Columbia,5,4,9,2478
2018-08-31,CA,Fresno,1,0,1,195
2017-05-31,WA,Lewis,0,0,0,24822
2022-07-31,WA,Okanogan,88,49,137,26298
2020-06-30,WA,Asotin,16,12,28,12321
2018-07-31,WA,Klickitat,24,31,55,15220
2017-09-30,WA,Douglas,0,0,0,11592
2019-01-31,CA,Shasta,1,0,1,43
2019-04-30,WA,San Juan,0,0,0,5834
2018-03-31,WA,Mason,0,0,0,19793
2019-06-30,WA,Whatcom,2,0,2,42910
2021-01-31,WA,Yakima,0,0,0,61081
2021-05-31,WA,Douglas,0,0,0,12664
2018-11-30,WA,Yakima,78,98,176,164686
2022-07-31,WA,Cowlitz,349,171,520,70574
2018-08-31,WA,Douglas,0,0,0,12028
2021-05-31,WA,Wahkiakum,0,0,0,1799
2023-04-30,CA,San Diego,16,9,25,1874
2019-10-31,WA,Franklin,0,0,0,19656
2020-10-31,CA,San Joaquin,1,0,1,113
2023-07-31,WA,Clallam,19,0,19,21216
2022-01-31,WA,Cowlitz,273,164,437,71316
2019-08-31,WA,Skagit,310,209,519,92306
2020-07-31,WA,Garfield,0,1,1,1350
2017-02-28,WA,Snohomish,1,0,1,122505
2021-09-30,WA,Benton,0,0,0,43672
2020-08-31,WA,Whitman,0,0,0,8480
2020-07-31,WA,Okanogan,37,34,71,25923
2019-05-31,WA,Wahkiakum,0,0,0,1743
2017-10-31,WA,Island,138,153,291,61081
2022-01-31,CA,San Diego,15,8,23,2380
2021-08-31,CA,Alameda,4,0,4,227
2020-05-31,WA,Kitsap,1312,678,1990,179656
2017-03-31,CA,Monterey,0,1,1,218
2018-06-30,WA,Columbia,0,0,0,1527
2017-03-31,WA,Kittitas,0,0,0,13423
2019-12-31,WA,Snohomish,0,0,0,123277
2018-02-28,WA,Whatcom,556,249,805,145579
2019-02-28,WA,Jefferson,0,0,0,9623
2019-05-31,WA,Stevens,20,29,49,31678
2022-05-31,CA,Marin,0,1,1,29
2023-04-30,WA,Pend Oreille,31,13,44,8881
2019-07-31,WA,Spokane,557,435,992,312718
2017-03-31,WA,Thurston,0,0,0,53299
2018-06-30,CA,Marin,1,0,1,55
2021-12-31,WA,Garfield,0,3,3,1350
2020-05-31,WA,Adams,8,7,15,12719
2021-12-31,CA,Sacramento,2,0,2,207
2017-07-31,WA,Grays Harbor,36,35,71,44850
2020-08-31,CA,San Mateo,0,1,1,105
2020-11-30,WA,Pierce,0,0,0,144543
2017-07-31,WA,Kitsap,1,0,1,52511
2023-01-31,WA,Clallam,9,0,9,21848
2018-01-31,WA,Grant,29,37,66,62283
2021-11-30,WA,Lewis,199,163,362,59631
2023-01-31,WA,Franklin,262,124,386,61842
2022-11-30,WA,Kitsap,28,0,28,53049
2021-04-30,WA,Whitman,59,44,103,21991
2020-02-29,WA,Yakima,0,0,0,59625
2019-06-30,WA,Cowlitz,0,0,0,28865
2023-05-31,WA,San Juan,12,0,12,5866
2022-01-31,WA,Franklin,169,101,270,62152
2022-08-31,WA,Grays Harbor,2,0,2,21214
2019-06-30,WA,Pacific,0,0,0,7654
2020-08-31,WA,Skagit,1,0,1,32634
2022-03-31,WA,Klickitat,0,0,0,8311
2019-12-31,WA,Thurston,0,0,0,55729
2017-09-30,WA,Douglas,35,29,64,26927
2018-03-31,WA,Lincoln,2,5,7,7578
2022-02-28,WA,Stevens,58,47,105,30105
2021-08-31,WA,Clark,0,0,0,84180
2021-01-31,WA,Pierce,0,0,0,144891
2020-09-30,WA,Cowlitz,0,0,0,28936
2022-05-31,WA,Snohomish,6,0,6,124132
2019-03-31,WA,Lincoln,3,6,9,7733
2017-05-31,WA,Snohomish,1,0,1,121865
2018-10-31,WA,Mason,101,108,209,46356
2020-08-31,WA,Clark,2135,1076,3211,318235
2017-09-30,WA,King,10654,4350,15004,1372562
2020-09-30,WA,Asotin,0,0,0,6693
2023-05-31,WA,Thurston,3033,1203,4236,189258
2017-11-30,WA,Kittitas,34,24,58,28271
2022-07-31,WA,Douglas,1,0,1,12747
2019-08-31,CA,Santa Clara,4,2,6,365
2020-04-30,CA,Santa Cruz,1,0,1,37
2019-05-31,WA,Spokane,529,422,951,310923
2017-09-30,CA,Monterey,0,2,2,195
2018-07-31,WA,San Juan,0,0,0,5730
2022-02-28,WA,Skagit,1,0,1,32638
2017-09-30,WA,Grant,0,0,0,25425
2020-05-31,WA,Snohomish,4402,1748,6150,533885
2021-10-31,WA,Pend Oreille,0,0,0,5687
2018-10-31,WA,Stevens,0,0,0,18721
2021-10-31,WA,Jefferson,0,0,0,9592
2017-06-30,CA,San Diego,5,1,6,2725
2021-03-31,WA,San Juan,0,0,0,5885
2021-05-31,CA,Orange,4,3,7,425
2017-10-31,WA,Spokane,286,238,524,298905
2020-12-31,WA,San Juan,0,0,0,5874
2019-04-30,WA,Grays Harbor,0,0,0,20395
2021-09-30,WA,Stevens,0,0,0,18892
2021-11-30,WA,Lewis,0,0,0,26719
2020-02-29,CA,Alameda,3,1,4,282
2023-03-31,CA,Alameda,3,0,3,152
2018-04-30,CA,Tuolumne,0,1,1,13
2019-10-31,WA,Mason,0,0,0,20466
2019-12-31,CA,Riverside,4,1,5,637
2017-03-31,WA,Pierce,0,0,0,138175
2018-06-30,WA,San Juan,145,61,206,14069
2020-03-31,WA,Kitsap,1,0,1,54213
2021-08-31,WA,Lewis,0,0,0,26748
2017-10-31,WA,Okanogan,0,0,0,16246
2019-09-30,WA,Pend Oreille,0,0,0,5712
2020-10-31,WA,Klickitat,59,44,103,15003
2017-12-31,WA,Ferry,0,0,0,3523
2019-07-31,WA,Wahkiakum,2,2,4,3007
2023-05-31,WA,Walla Walla,5,0,5,13644
2023-07-31,WA,Island,1106,442,1548,59897
2022-01-31,WA,Columbia,0,0,0,1557
2017-12-31,WA,San Juan,0,0,0,5604
2018-07-31,WA,Kitsap,1,0,1,53372
2022-03-31,CA,Santa Cruz,1,0,1,24
2019-01-31,WA,Whatcom,778,375,1153,149711
2023-07-31,WA,Walla Walla,5,0,5,13311
2019-10-31,WA,Columbia,3,2,5,2435
2021-03-31,WA,Stevens,0,0,0,18796
2020-10-31,WA,Spokane,0,0,0,100211
2022-07-31,WA,Yakima,353,198,551,166690
2018-10-31,WA,Lincoln,2,6,8,7740
2022-02-28,WA,Island,1,0,1,21490
2017-04-30,WA,Spokane,236,208,444,295746
2021-02-28,WA,Columbia,5,4,9,2453
2019-02-28,CA,San Mateo,2,1,3,125
2022-09-30,CA,Sacramento,3,0,3,181
2021-11-30,CA,Placer,2,0,2,70
2021-02-28,CA,Santa Cruz,1,0,1,30
2017-12-31,WA,Thurston,0,0,0,53761
2018-06-30,WA,Lincoln,2,6,8,7685
2017-02-28,WA,Lincoln,0,0,0,4463
2023-03-31,WA,Clark,77,0,77,81356
2019-11-30,WA,Walla Walla,64,61,125,36282
2021-11-30,WA,Clark,0,0,0,84070
2018-02-28,WA,Pend Oreille,4,3,7,9418
2021-10-31,WA,Kitsap,0,0,0,54245
2021-04-30,WA,Wahkiakum,0,0,0,1806
2021-06-30,WA,Walla Walla,113,74,187,36614
2022-07-31,WA,Douglas,138,60,198,28404
2019-01-31,WA,Garfield,1,1,2,1332
2017-01-31,CA,San Diego,4,2,6,2895
2019-05-31,WA,Pend Oreille,0,0,0,5743
2022-06-30,WA,Kitsap,2393,1054,3447,178654
2023-01-31,WA,Spokane,22,0,22,101916
2017-05-31,WA,Jefferson,103,59,162,23819
2023-03-31,WA,Island,24,0,24,21070
2019-01-31,WA,Columbia,0,0,0,1529
2020-09-30,WA,Skagit,447,228,675,91505
2017-07-31,WA,Columbia,1,1,2,2350
2017-07-31,WA,Stevens,8,23,31,31395
2022-01-31,CA,San Bernardino,1,1,2,349
2021-09-30,WA,Grays Harbor,0,0,0,21400
2017-02-28,WA,Thurston,0,0,0,53345
2021-05-31,WA,Mason,0,0,0,21339
2021-09-30,WA,Kitsap,1993,907,2900,180805
2019-06-30,WA,Yakima,105,104,209,165147
2017-08-31,WA,King,7,1,8,186770
2021-09-30,CA,Alameda,4,0,4,221
2021-10-31,WA,Asotin,0,0,0,6748
2022-12-31,WA,Lewis,268,182,450,59910
2019-11-30,WA,Island,1,0,1,21317
2020-11-30,CA,Alameda,3,0,3,259
2017-01-31,CA,Santa Barbara,0,1,1,133
2020-08-31,WA,Clallam,239,171,410,49948
2020-05-31,CA,Riverside,3,1,4,625
2022-09-30,CA,Santa Clara,10,2,12,194
2017-11-30,WA,Pierce,0,0,0,137030
2018-07-31,WA,Pierce,1262,1194,2456,533502
2023-02-28,CA,Riverside,7,0,7,380
2022-02-28,CA,San Luis Obispo,1,0,1,55
2023-02-28,WA,Snohomish,10921,2841,13762,529463
2023-07-31,WA,Grant,12,0,12,27240
2017-11-30,CA,Orange,3,1,4,584
2019-09-30,WA,Lincoln,0,0,0,4690
2018-12-31,WA,Adams,5,6,11,12744
2023-02-28,WA,Stevens,99,58,157,29968
2018-05-31,WA,Adams,0,0,0,5158
2022-05-31,WA,Pacific,0,0,0,7950
2019-04-30,WA,Klickitat,0,0,0,8222
2019-08-31,WA,Lincoln,2,10,12,7786
2020-05-31,WA,Skamania,30,17,47,8525
2022-05-31,WA,Douglas,131,58,189,28516
2018-09-30,WA,Cowlitz,0,0,0,28600
2022-05-31,WA,Ferry,0,0,0,3569
2019-11-30,WA,Kittitas,89,46,135,30012
2017-05-31,CA,Monterey,0,1,1,209
2021-10-31,WA,Mason,0,0,0,21283
2021-03-31,WA,King,6,1,7,184559
2022-04-30,WA,King,39326,10828,50154,1351160
2019-10-31,WA,Pierce,0,0,0,140688
2021-02-28,WA,Clark,0,0,0,83537
2017-04-30,WA,Grays Harbor,29,30,59,44477
2021-06-30,WA,Lincoln,0,0,0,4754
2020-03-31,WA,Pierce,2310,1693,4003,551180
2020-07-31,WA,Walla Walla,0,0,0,13755
2020-06-30,WA,Whitman,44,48,92,22140
2021-02-28,WA,Chelan,301,88,389,54492
2018-02-28,WA,Wahkiakum,0,2,2,2860
2019-01-31,WA,Pierce,0,0,0,139124
2018-06-30,CA,Monterey,0,1,1,185
2018-07-31,WA,Lincoln,0,0,0,4557
2022-02-28,WA,Skamania,0,0,0,4001
2017-03-31,WA,Whitman,9,18,27,21937
2018-06-30,WA,Benton,0,0,0,41024
2022-03-31,WA,Skagit,1,0,1,32552
2021-11-30,WA,Wahkiakum,17,10,27,3091
2019-05-31,WA,Whatcom,2,0,2,42822
2022-08-31,WA,Pacific,0,0,0,7860
2021-12-31,WA,Walla Walla,0,0,0,14090
2020-10-31,WA,Wahkiakum,0,0,0,1764
2017-11-30,WA,Grays Harbor,0,0,0,20019
2019-11-30,WA,Snohomish,0,0,0,123166
2020-02-29,WA,San Juan,0,0,0,5925
2023-05-31,WA,Douglas,198,61,259,28577
2018-07-31,WA,Snohomish,2404,1295,3699,522666
2018-08-31,WA,Yakima,67,92,159,164210
2021-05-31,WA,Whitman,0,0,0,8571
2019-09-30,WA,Benton,0,0,0,42229
2021-09-30,WA,Spokane,0,0,0,102568
2020-12-31,WA,Klickitat,62,43,105,14980
2021-03-31,CA,Contra Costa,3,4,7,273
2019-11-30,WA,Yakima,0,0,0,59589
2018-02-28,WA,Ferry,1,3,4,4396
2020-06-30,CA,Santa Clara,7,2,9,298
2018-01-31,WA,Skagit,170,140,310,89781
2021-02-28,WA,Adams,10,6,16,12975
2017-02-28,WA,Thurston,351,309,660,184902
2021-09-30,CA,Contra Costa,2,4,6,263
2021-07-31,WA,Asotin,0,0,0,6768
2022-06-30,WA,Pierce,5062,2311,7373,546060
2020-02-29,WA,Whitman,42,48,90,22621
2022-02-28,WA,Kitsap,0,0,0,54096
2018-01-31,WA,Cowlitz,0,0,0,28201
2020-07-31,WA,Kittitas,104,47,151,29761
2021-09-30,WA,Asotin,20,17,37,12736
2021-08-31,WA,Island,645,318,963,63236
2022-05-31,WA,San Juan,499,152,651,14097
2019-02-28,WA,Pend Oreille,0,0,0,5738
2018-09-30,WA,Lewis,84,66,150,57934
2023-05-31,WA,Adams,25,12,37,12934
2018-08-31,WA,Chelan,0,0,0,21983
2020-04-30,CA,Sacramento,1,0,1,268
2021-08-31,WA,Pierce,3774,2031,5805,559092
2021-05-31,WA,King,6,1,7,184688
2018-06-30,WA,Klickitat,25,30,55,15166
2022-11-30,CA,Sacramento,3,0,3,171
2022-06-30,WA,Whitman,87,60,147,22018
2023-06-30,WA,Kitsap,76,0,76,51739
2021-11-30,WA,Stevens,0,0,0,18924
2023-03-31,CA,Sonoma,1,1,2,53
2017-04-30,WA,Wahkiakum,0,2,2,2848
2019-12-31,WA,Benton,0,0,0,42486
2020-03-31,WA,Skamania,0,0,0,4082
2022-02-28,WA,Lincoln,7,17,24,7685
2017-12-31,CA,Tuolumne,0,1,1,14
2019-10-31,WA,Snohomish,3897,1683,5580,535121
2020-06-30,WA,Kitsap,1330,686,2016,179815
2019-03-31,WA,Franklin,52,68,120,59371
2019-02-28,WA,King,6,1,7,182021
2022-01-31,WA,Stevens,0,0,0,18938
2022-03-31,WA,San Juan,1,0,1,5995
2018-07-31,WA,Asotin,11,8,19,12637
2021-01-31,WA,Benton,0,0,0,43331
2018-11-30,WA,Klickitat,0,0,0,8183
2022-06-30,WA,Snohomish,8361,2528,10889,532982
2018-01-31,WA,Whitman,18,20,38,22475
2019-07-31,WA,Yakima,0,0,0,59260
2023-03-31,WA,Yakima,9,0,9,60996
2022-02-28,WA,Pacific,0,0,0,8006
2021-06-30,WA,Klickitat,70,51,121,15279
2022-04-30,CA,Placer,2,0,2,69
2023-05-31,WA,Stevens,1,0,1,18642
2020-11-30,WA,Pacific,0,0,0,7762
2020-04-30,WA,Whitman,0,0,0,8532
2023-02-28,WA,Clark,70,0,70,81540
2022-04-30,WA,Pend Oreille,16,10,26,9032
2020-04-30,WA,Grant,59,71,130,65268
2020-11-30,WA,Okanogan,0,0,0,16579
2022-10-31,WA,Skagit,886,349,1235,89523
2018-03-31,WA,Stevens,9,21,30,31603
2020-02-29,WA,Columbia,3,3,6,2433
2018-12-31,WA,King,6,1,7,182653
2021-12-31,WA,Mason,0,0,0,21219
2017-08-31,WA,Pend Oreille,0,0,0,5552
2021-03-31,CA,Santa Clara,8,2,10,261
2022-02-28,WA,Walla Walla,152,91,243,36233
2021-12-31,CA,San Luis Obispo,1,0,1,56
2018-01-31,WA,Walla Walla,30,33,63,35373
2022-03-31,WA,Chelan,437,122,559,54596
2021-02-28,WA,Klickitat,0,0,0,8118
2019-09-30,WA,Franklin,0,0,0,19536
2018-05-31,WA,Kittitas,44,32,76,28906
2021-03-31,WA,Whatcom,1298,576,1874,150446
2019-08-31,WA,Cowlitz,0,0,0,28900
2017-09-30,WA,Clallam,0,0,0,21085
2023-02-28,WA,Chelan,566,151,717,54278
2022-04-30,WA,Franklin,0,0,0,20942
2022-07-31,WA,Klickitat,0,0,0,8286
2023-03-31,WA,San Juan,10,0,10,5884
2017-12-31,WA,King,11277,4684,15961,1370800
2020-08-31,WA,Lewis,112,117,229,58206
2021-04-30,WA,Skamania,40,30,70,8366
2021-07-31,WA,Yakima,0,0,0,61720
2021-03-31,WA,Grant,93,87,180,66441
2023-01-31,WA,Cowlitz,417,193,610,70247
2017-11-30,WA,Asotin,7,5,12,12514
2022-04-30,WA,Mason,0,0,0,21131
2019-03-31,WA,Benton,236,251,487,132992
2022-09-30,WA,Adams,22,10,32,13017
2020-04-30,CA,Santa Clara,7,2,9,318
2022-02-28,WA,Whatcom,4,0,4,43608
2022-11-30,WA,King,46991,12053,59044,1341209
2019-12-31,WA,Ferry,0,0,0,3580
2022-12-31,WA,Yakima,6,0,6,61209
2023-02-28,WA,Pacific,71,82,153,15680
2020-09-30,CA,Monterey,0,1,1,157
2022-07-31,WA,Island,6,0,6,21337
2020-07-31,WA,Yakima,139,119,258,165771
2021-11-30,CA,Alameda,4,0,4,211
2019-03-31,WA,Kittitas,71,37,108,29440
2022-03-31,WA,Grays Harbor,205,157,362,49309
2018-08-31,WA,Grant,34,49,83,63544
2023-06-30,WA,Clallam,545,283,828,48445
2021-09-30,WA,Cowlitz,246,154,400,72035
2019-05-31,WA,Clark,1475,913,2388,313255
2022-01-31,CA,Fresno,1,0,1,154
2020-08-31,WA,Skamania,0,0,0,4023
2021-09-30,WA,Lewis,185,149,334,59589
2021-05-31,WA,Island,599,310,909,63247
2020-01-31,CA,Orange,7,2,9,506
2023-06-30,WA,Franklin,302,137,439,61004
2019-11-30,CA,Alameda,5,1,6,291
2018-10-31,WA,Island,244,216,460,63045
2021-01-31,WA,Franklin,0,0,0,20491
2019-12-31,WA,Lincoln,0,0,0,4683
2017-07-31,WA,Klickitat,0,0,0,7953
2019-12-31,WA,Kittitas,90,46,136,30054
2021-03-31,CA,Fresno,1,0,1,167
2022-03-31,WA,Klickitat,96,54,150,15336
2018-08-31,WA,Pend Oreille,5,5,10,9583
2021-11-30,WA,Snohomish,6837,2229,9066,538413
2019-11-30,WA,Pacific,0,0,0,7740
2019-10-31,WA,Ferry,0,0,0,3575
2022-01-31,WA,Lincoln,0,0,0,4835
2020-08-31,WA,Douglas,0,0,0,12339
2022-03-31,WA,Pend Oreille,16,10,26,9051
2023-04-30,WA,Clallam,18,0,18,21654
2021-03-31,WA,Thurston,0,0,0,56530
2019-06-30,WA,Skagit,298,200,498,91940
2018-04-30,WA,Ferry,2,3,5,4414
2019-03-31,WA,Pierce,1635,1457,3092,539431
2017-06-30,WA,Okanogan,4,17,21,25707
2021-06-30,CA,Fresno,1,0,1,168
2020-02-29,WA,Adams,7,7,14,12913
2022-06-30,WA,Columbia,7,0,7,2444
2023-06-30,WA,Lewis,327,206,533,58421
2021-11-30,WA,Cowlitz,265,159,424,71773
2020-11-30,WA,Whatcom,1203,534,1737,149736
2023-03-31,WA,Thurston,2830,1176,4006,190713
2021-11-30,WA,Kitsap,0,0,0,54275
2017-01-31,WA,Pierce,0,0,0,138768
2022-01-31,CA,Sacramento,2,0,2,204
2018-07-31,WA,Kitsap,809,473,1282,178849
2023-03-31,WA,Ferry,19,4,23,4330
2022-09-30,CA,Sonoma,0,1,1,67
2022-03-31,CA,Marin,0,1,1,30
2019-04-30,WA,Okanogan,0,0,0,16478
2018-02-28,WA,Lincoln,0,0,0,4511
2017-07-31,WA,Asotin,0,0,0,6532
2019-09-30,WA,King,6,1,7,182395
2023-07-31,WA,Clark,102,0,102,79248
2018-04-30,WA,Garfield,0,0,0,950
2022-10-31,WA,Lincoln,12,17,29,7735
2018-05-31,WA,Benton,0,0,0,40984
2020-09-30,WA,Thurston,0,0,0,56132
2020-06-30,WA,San Juan,0,0,0,5854
2023-01-31,WA,Grant,230,113,343,66923
2018-08-31,CA,San Diego,7,2,9,2568
2018-10-31,WA,Benton,0,0,0,41429
2020-09-30,CA,Santa Cruz,1,0,1,31
2018-06-30,WA,Chelan,0,0,0,21872
2022-05-31,WA,Lincoln,8,18,26,7692
2021-04-30,WA,Douglas,0,0,0,12625
2023-05-31,WA,Ferry,0,0,0,3538
2019-07-31,CA,Contra Costa,2,2,4,377
2018-11-30,CA,Tuolumne,0,1,1,12
2017-06-30,WA,Grant,20,27,47,60844
2017-06-30,WA,Klickitat,22,24,46,14799
2020-04-30,CA,Solano,1,0,1,211
2021-05-31,WA,Island,0,0,0,21611
2019-07-31,WA,Grant,43,61,104,65017
2021-03-31,WA,Wahkiakum,9,7,16,3083
2018-05-31,WA,Franklin,0,0,0,18644
2021-11-30,WA,Walla Walla,0,0,0,14078
2021-06-30,WA,Columbia,0,0,0,1546
2018-02-28,WA,Douglas,0,0,0,11812
2018-07-31,WA,King,7,1,8,182983
2021-08-31,CA,Placer,2,0,2,70
2019-01-31,CA,Los Angeles,7,5,12,1096
2020-02-29,WA,Island,1,0,1,21333
2018-05-31,WA,Yakima,62,84,146,163646
2020-08-31,CA,Ventura,1,2,3,278
2017-11-30,WA,Chelan,83,36,119,52832
2018-05-31,WA,Pacific,16,19,35,15552
2020-01-31,WA,Klickitat,0,0,0,8299
2022-04-30,CA,Sacramento,2,0,2,198
2018-10-31,CA,Tuolumne,0,1,1,12
2020-02-29,WA,Benton,338,320,658,135315
2018-11-30,CA,Riverside,2,2,4,683
2021-03-31,WA,Pierce,3126,1845,4971,556748
2022-03-31,WA,Franklin,179,106,285,62085
2017-08-31,WA,Douglas,0,0,0,11570
2021-03-31,WA,Mason,185,137,322,47894
2017-03-31,WA,Adams,2,4,6,12107
2017-06-30,WA,Skagit,1,0,1,31458
2017-04-30,WA,Skamania,9,8,17,8521
2021-02-28,WA,Asotin,0,0,0,6696
2017-05-31,WA,Skagit,1,0,1,31389
2022-09-30,WA,Garfield,1,3,4,1324
2022-11-30,WA,Asotin,0,0,0,6694
2023-05-31,WA,Columbia,0,0,0,1546
2018-01-31,WA,Island,0,0,0,20786
2018-08-31,CA,Tuolumne,0,1,1,12
2019-06-30,WA,Pierce,1808,1556,3364,543069
2017-08-31,WA,Clallam,96,79,175,48546
2020-07-31,WA,Whatcom,3,0,3,43156
2022-06-30,WA,San Juan,1,0,1,5986
2022-06-30,WA,Walla Walla,172,101,273,35914
2017-09-30,WA,Franklin,29,48,77,56181
2022-03-31,WA,Douglas,125,56,181,28528
2018-11-30,WA,Columbia,2,2,4,2437
2019-09-30,WA,Franklin,51,73,124,60363
2017-05-31,WA,Island,113,129,242,59919
2017-02-28,CA,Tulare,1,0,1,200
2020-10-31,CA,El Dorado,1,0,1,32
2018-09-30,WA,Garfield,1,1,2,1320
2020-09-30,WA,Lincoln,5,10,15,7595
2021-10-31,CA,Los Angeles,7,9,16,833
2018-12-31,WA,Clark,1246,841,2087,311394
2018-11-30,WA,Walla Walla,38,52,90,36092
2021-05-31,WA,Snohomish,5729,2002,7731,540294
2020-07-31,WA,Yakima,0,0,0,60200
2021-04-30,WA,Cowlitz,0,0,0,29173
2018-11-30,WA,Stevens,16,27,43,31791
2021-10-31,WA,Okanogan,66,44,110,26572
2017-02-28,WA,Whitman,0,0,0,8399
2020-01-31,WA,Kittitas,0,0,0,14666
2018-07-31,WA,Asotin,0,0,0,6628
2022-10-31,WA,Skamania,0,0,0,3897
2021-07-31,WA,King,31555,9349,40904,1366948
2017-06-30,WA,Yakima,0,0,0,57351
2022-04-30,WA,Clark,3864,1692,5556,317894
2022-05-31,WA,Pend Oreille,16,11,27,9013
2020-05-31,WA,Cowlitz,0,0,0,28759
2018-12-31,WA,Kitsap,1,0,1,53636
2021-04-30,WA,Kitsap,1733,814,2547,180539
2023-06-30,WA,Whatcom,2467,871,3338,145997
2020-08-31,WA,Jefferson,249,144,393,24652
2021-05-31,CA,Alameda,3,0,3,237
2021-11-30,CA,San Luis Obispo,1,0,1,57
2021-03-31,WA,Okanogan,57,35,92,26225
2018-12-31,WA,Douglas,50,34,84,28009
2022-12-31,WA,Jefferson,6,0,6,9367
2022-02-28,CA,Santa Cruz,1,0,1,24
2021-07-31,WA,Columbia,6,2,8,2472
2017-02-28,WA,Clallam,0,0,0,21029
2019-03-31,WA,Spokane,491,393,884,307777
2017-10-31,WA,Lincoln,2,5,7,7575
2018-07-31,CA,San Francisco,1,1,2,124
2017-05-31,WA,Okanogan,3,16,19,25686
2023-03-31,WA,Pend Oreille,28,13,41,8917
2021-07-31,WA,Pacific,0,0,0,7961
2017-09-30,WA,Skagit,1,0,1,31550
2019-12-31,WA,Garfield,0,0,0,969
2018-02-28,WA,Island,165,171,336,61877
2021-02-28,WA,Skamania,0,0,0,4030
2018-12-31,CA,San Mateo,2,1,3,128
2017-03-31,WA,Skagit,118,91,209,87516
2023-04-30,WA,Pacific,76,89,165,15580
2020-09-30,WA,Clallam,1,0,1,21773
2019-09-30,CA,Placer,1,0,1,96
2017-07-31,WA,Walla Walla,27,26,53,34886
2017-09-30,WA,San Juan,0,0,0,5559
2018-07-31,WA,Pend Oreille,0,0,0,5699
2017-07-31,WA,Adams,0,0,0,5123
2021-11-30,WA,Grays Harbor,0,0,0,21428
2019-04-30,WA,Spokane,512,407,919,309575
2018-07-31,WA,Pacific,19,21,40,15621
2017-04-30,WA,Mason,0,0,0,19242
2018-02-28,WA,Stevens,0,0,0,18404
2019-11-30,WA,Klickitat,45,38,83,15673
2020-04-30,WA,Thurston,1141,730,1871,197497
2021-11-30,WA,Adams,0,0,0,5421
2017-12-31,CA,San Mateo,0,1,1,147
2019-12-31,WA,Adams,0,0,0,5198
2017-06-30,WA,Benton,0,0,0,40055
2017-03-31,WA,Snohomish,1,0,1,122199
2021-10-31,WA,Douglas,0,0,0,12679
2018-04-30,WA,Wahkiakum,0,0,0,1668
2021-12-31,WA,Pierce,4236,2127,6363,555764
2019-02-28,WA,San Juan,193,69,262,14274
2023-07-31,WA,Klickitat,156,65,221,14764
2017-06-30,WA,Benton,148,143,291,128515
2021-09-30,WA,Adams,16,14,30,13045
2020-05-31,WA,Lewis,99,108,207,58242
2021-04-30,WA,Grant,102,86,188,66806
2022-11-30,WA,Skamania,89,51,140,8127
2020-04-30,WA,Lincoln,0,0,0,4627
2018-04-30,WA,Pend Oreille,0,0,0,5654
2023-04-30,WA,Skagit,18,0,18,31863
2021-12-31,CA,Marin,0,1,1,32
2021-01-31,WA,Kitsap,1607,765,2372,179318
2017-01-31,WA,Klickitat,20,22,42,14793
2022-03-31,WA,Clark,2,0,2,83493
2021-01-31,WA,Lincoln,6,12,18,7632
2023-05-31,WA,Clallam,20,0,20,21594
2017-08-31,WA,Whatcom,2,0,2,41764
2021-01-31,WA,Whatcom,1253,564,1817,150089
2022-02-28,WA,Wahkiakum,17,11,28,3096
2023-02-28,WA,Adams,2,0,2,5362
2021-10-31,WA,Benton,0,0,0,43707
2020-01-31,WA,Spokane,684,467,1151,316758
2018-05-31,WA,King,12744,5480,18224,1369589
2023-01-31,CA,Sacramento,4,0,4,159
2019-06-30,WA,San Juan,212,72,284,14409
2022-05-31,WA,Benton,2,0,2,43549
2019-04-30,WA,Cowlitz,89,101,190,72747
2019-09-30,WA,Kittitas,81,44,125,29832
2019-01-31,WA,Douglas,51,35,86,28011
2021-11-30,CA,Santa Clara,7,1,8,230
2021-02-28,WA,Snohomish,5270,1894,7164,538252
2022-04-30,WA,Kitsap,1,0,1,53850
2018-12-31,CA,Shasta,1,0,1,42
2019-06-30,WA,Snohomish,3473,1593,5066,531506
2017-02-28,CA,Alameda,3,1,4,389
2019-04-30,CA,Alameda,3,2,5,311
2021-03-31,WA,Pierce,0,0,0,145348
2019-07-31,WA,Klickitat,35,33,68,15579
2021-01-31,WA,Klickitat,0,0,0,8117
2022-01-31,WA,Wahkiakum,0,0,0,1816
2019-01-31,WA,Skamania,0,0,0,4008
2020-01-31,WA,Franklin,0,0,0,19851
2021-06-30,WA,Spokane,1069,646,1715,326466
2018-11-30,WA,Thurston,707,567,1274,195458
2022-12-31,WA,Grays Harbor,246,160,406,48674
2023-04-30,WA,Pierce,139,0,139,137180
2019-12-31,CA,Shasta,1,0,1,37
2022-08-31,WA,Stevens,1,0,1,18926
2019-11-30,WA,Kittitas,0,0,0,14619
2019-01-31,WA,Thurston,0,0,0,54922
2020-08-31,WA,Chelan,248,80,328,54176
2021-07-31,CA,Contra Costa,2,3,5,262
2022-12-31,WA,Snohomish,92,0,92,122549
2021-04-30,WA,Lincoln,0,0,0,4751
2023-01-31,WA,Columbia,0,0,0,1579
2019-03-31,WA,Asotin,12,9,21,12660
2019-06-30,CA,Alameda,4,2,6,306
2019-04-30,WA,Mason,117,118,235,46864
2022-02-28,WA,Asotin,22,18,40,12641
2022-01-31,CA,Riverside,5,1,6,490
2022-07-31,CA,San Bernardino,1,1,2,310
2019-07-31,WA,San Juan,0,0,0,5890
2017-01-31,WA,King,8804,3621,12425,1387384
2021-01-31,CA,Kern,0,1,1,214
2019-09-30,WA,Jefferson,0,0,0,9682
2020-02-29,WA,Stevens,33,33,66,31445
2018-10-31,CA,Alameda,0,2,2,333
2019-05-31,WA,Grays Harbor,73,84,157,47839
2022-03-31,WA,Island,1,0,1,21479
2021-09-30,WA,San Juan,0,0,0,5983
2022-10-31,WA,Benton,7,0,7,43350
2020-09-30,WA,Lincoln,0,0,0,4640
2020-03-31,WA,Pend Oreille,0,0,0,5757
2018-01-31,CA,San Mateo,0,1,1,142
2023-04-30,CA,Santa Clara,8,2,10,146
2020-03-31,WA,San Juan,291,86,377,14281
2020-03-31,WA,Island,1,0,1,21265
2020-03-31,WA,Okanogan,34,31,65,26068
2021-08-31,CA,Orange,5,2,7,402
2018-11-30,WA,San Juan,176,68,244,14214
2017-06-30,WA,Adams,2,3,5,12204
2017-07-31,WA,Pacific,0,0,0,7495
2020-12-31,CA,Solano,1,0,1,205
2021-04-30,WA,Clallam,1,0,1,21992
2020-04-30,WA,Kitsap,1312,676,1988,180568
2018-07-31,WA,Walla Walla,34,44,78,35739
2017-08-31,WA,Spokane,1,0,1,90996
2018-07-31,WA,Benton,0,0,0,41093
2018-09-30,WA,Lincoln,2,6,8,7748
2019-12-31,WA,Spokane,1,0,1,96378
2023-03-31,WA,Skamania,1,0,1,3842
2017-01-31,WA,Clallam,73,64,137,48005
2019-07-31,WA,Stevens,19,30,49,31721
2020-06-30,WA,Adams,9,7,16,12786
2020-11-30,WA,Kittitas,125,52,177,29743
2022-12-31,WA,Grant,4,0,4,28064
2021-04-30,WA,Garfield,0,0,0,1007
2018-04-30,WA,Franklin,37,59,96,57403
2021-12-31,WA,Chelan,0,0,0,23108
2017-05-31,WA,Whatcom,2,0,2,41518
2021-10-31,WA,Benton,595,426,1021,136009
2019-02-28,WA,Whitman,0,0,0,8490
2018-12-31,WA,Island,276,225,501,63178
2018-01-31,WA,Yakima,60,76,136,162512
2018-09-30,WA,Stevens,13,27,40,31699
2017-12-31,WA,Pend Oreille,3,4,7,9440
2021-02-28,CA,Alameda,3,0,3,253
2022-02-28,WA,Douglas,0,0,0,12686
2017-09-30,WA,Skamania,0,0,0,3878
2020-09-30,WA,Island,444,280,724,62886
2022-11-30,CA,Santa Clara,9,2,11,177
2019-01-31,CA,San Francisco,2,1,3,114
2019-12-31,WA,Grant,55,68,123,65625
2022-12-31,CA,San Diego,17,9,26,2033
2022-03-31,WA,Adams,16,11,27,12982
2020-04-30,WA,Walla Walla,0,0,0,13622
2021-08-31,WA,Columbia,7,2,9,2458
2020-08-31,WA,Stevens,35,36,71,30494
2017-01-31,WA,Grays Harbor,27,24,51,44315
2023-03-31,WA,Stevens,103,60,163,29814
2017-10-31,WA,Columbia,1,1,2,2393
2019-03-31,WA,Clallam,154,129,283,50317
2019-04-30,WA,Stevens,19,27,46,31638
2019-09-30,CA,Santa Cruz,1,0,1,36
2017-10-31,WA,Lewis,53,39,92,56275
2017-07-31,WA,Pend Oreille,3,4,7,9321
2021-03-31,WA,Spokane,952,584,1536,322674
2022-09-30,WA,Okanogan,93,49,142,26316
2020-11-30,WA,Benton,0,0,0,43111
2021-02-28,WA,Mason,177,135,312,47649
2022-10-31,WA,Mason,6,0,6,20938
2022-09-30,WA,Whatcom,1952,772,2724,148826
2020-01-31,WA,Stevens,33,32,65,31499
2022-10-31,WA,Ferry,0,0,0,3593
2022-01-31,WA,Okanogan,0,0,0,16692
2020-02-29,WA,Douglas,0,0,0,12320
2021-01-31,WA,Chelan,0,0,0,22844
2017-10-31,CA,San Mateo,0,1,1,149
2022-05-31,CA,San Joaquin,1,1,2,89
2022-04-30,WA,Whatcom,1775,717,2492,149078
2020-04-30,WA,Douglas,0,0,0,12271
2022-08-31,WA,Whatcom,13,0,13,43149
2021-01-31,CA,Sacramento,2,0,2,232
2021-03-31,WA,Clark,2578,1276,3854,320028
2020-10-31,WA,Lincoln,5,10,15,7609
2017-10-31,WA,Jefferson,0,0,0,9438
2020-09-30,WA,Adams,8,7,15,12918
2020-03-31,CA,San Francisco,2,1,3,99
2021-08-31,WA,Stevens,0,0,0,18913
2017-01-31,WA,Columbia,0,0,0,1543
2017-10-31,WA,Walla Walla,28,28,56,35147
2020-04-30,WA,Snohomish,0,0,0,123316
2021-08-31,WA,Jefferson,0,0,0,9611
2019-11-30,CA,Riverside,4,1,5,636
2022-05-31,WA,Chelan,2,0,2,23067
2022-01-31,WA,Island,1,0,1,21481
2021-01-31,CA,Orange,4,3,7,440
2019-06-30,WA,Kitsap,1050,605,1655,180817
2023-02-28,WA,Wahkiakum,26,15,41,3046
2017-11-30,WA,Adams,0,0,0,5141
2018-10-31,CA,Fresno,1,0,1,185
2019-08-31,WA,Whitman,34,44,78,22711
2019-02-28,WA,Kittitas,0,0,0,14260
2017-08-31,WA,Okanogan,4,18,22,25673
2020-07-31,WA,Benton,0,0,0,42882
2019-11-30,WA,Pend Oreille,7,7,14,9516
2021-09-30,WA,Snohomish,6456,2164,8620,539501
2019-09-30,WA,Stevens,0,0,0,18754
2020-08-31,WA,Pierce,2519,1704,4223,552476
2020-09-30,WA,Island,1,0,1,21261
2018-06-30,WA,Cowlitz,55,74,129,71731
2020-07-31,CA,Los Angeles,7,11,18,981
2020-01-31,WA,Lewis,0,0,0,26097
2018-07-31,CA,Monterey,0,1,1,184
2020-10-31,WA,Franklin,73,78,151,61101
2022-09-30,CA,Riverside,7,0,7,425
2019-05-31,WA,Chelan,153,67,220,54336
2019-04-30,WA,Snohomish,1,0,1,122012
2020-10-31,WA,Yakima,157,122,279,166886
2023-05-31,WA,Pacific,76,90,166,15521
2023-03-31,WA,Klickitat,133,59,192,15155
2023-06-30,WA,Mason,11,0,11,20405
2019-05-31,CA,San Diego,10,3,13,2672
2021-06-30,WA,Pend Oreille,0,0,0,5748
2017-02-28,WA,Skamania,0,0,0,3889
2019-08-31,WA,Wahkiakum,0,0,0,1763
2017-04-30,WA,King,9558,3882,13440,1378548
2019-04-30,WA,Grays Harbor,70,84,154,47665
2020-07-31,WA,Mason,160,134,294,47372
2021-10-31,WA,Skamania,58,39,97,8335
2022-11-30,CA,Santa Barbara,1,0,1,66
2017-11-30,WA,Kittitas,0,0,0,13759
2017-12-31,WA,Ferry,1,3,4,4402
2020-06-30,CA,Contra Costa,3,3,6,314
2018-06-30,WA,Adams,0,0,0,5165
2019-01-31,CA,Fresno,1,0,1,187
2019-08-31,WA,Pierce,0,0,0,140335
2018-11-30,CA,Monterey,0,1,1,190
2022-02-28,CA,San Mateo,2,0,2,76
2019-09-30,WA,Skamania,26,18,44,8787
2022-09-30,WA,Mason,4,0,4,21008
2023-04-30,WA,King,634,2,636,175590
2019-08-31,WA,Skagit,1,0,1,32553
2022-11-30,WA,Stevens,2,0,2,18874
2017-02-28,WA,Yakima,36,50,86,159126
2021-02-28,WA,Pend Oreille,12,4,16,9194
2019-12-31,WA,King,21951,7543,29494,1394823
2020-04-30,WA,Columbia,3,3,6,2407
2019-10-31,WA,Klickitat,43,37,80,15665
2019-05-31,CA,San Francisco,2,1,3,107
2019-03-31,WA,Okanogan,0,0,0,16439
2022-07-31,WA,King,41908,11450,53358,1347349
2019-02-28,WA,Pierce,1611,1428,3039,538910
2017-11-30,WA,Jefferson,116,71,187,24182
2021-10-31,WA,Franklin,0,0,0,20773
2021-11-30,WA,Whatcom,4,0,4,43702
2017-11-30,WA,Snohomish,1,0,1,121380
2017-07-31,WA,Spokane,262,213,475,296652
2020-03-31,WA,Lincoln,2,12,14,7750
2019-03-31,CA,San Mateo,2,1,3,126
2020-11-30,WA,Kitsap,1521,737,2258,179773
2018-04-30,WA,Mason,0,0,0,19808
2019-10-31,CA,San Diego,10,3,13,2804
2022-04-30,WA,Okanogan,79,48,127,26465
2023-05-31,CA,Ventura,2,1,3,190
2022-12-31,WA,Cowlitz,4,0,4,28376
2019-04-30,WA,Island,310,241,551,63255
2022-05-31,WA,Jefferson,425,215,640,24617
2019-12-31,WA,Mason,0,0,0,20527
2017-07-31,WA,Whatcom,2,0,2,41660
2022-12-31,WA,Whitman,110,67,177,21969
2020-07-31,WA,Chelan,240,82,322,54232
2019-04-30,WA,Pacific,23,28,51,15922
2019-08-31,CA,Ventura,0,2,2,309
2018-05-31,CA,San Francisco,0,1,1,128
2017-11-30,WA,Whatcom,524,214,738,144659
2017-06-30,CA,Tulare,1,0,1,198
2018-10-31,WA,Whitman,19,33,52,22745
2023-07-31,WA,Ferry,21,4,25,4197
2017-08-31,WA,Lincoln,0,0,0,4457
2019-04-30,WA,Island,0,0,0,21247
2020-04-30,WA,Pend Oreille,8,6,14,9257
2017-11-30,WA,Yakima,57,73,130,161627
2018-10-31,WA,Skagit,1,0,1,32334
2022-03-31,WA,Pacific,0,0,0,8008
2018-08-31,WA,Adams,0,0,0,5174
2020-09-30,WA,Kittitas,0,0,0,14601
2019-08-31,WA,Okanogan,25,26,51,26190
2022-06-30,WA,Douglas,131,58,189,28498
2022-03-31,CA,Santa Clara,9,1,10,225
2022-08-31,WA,Chelan,5,0,5,23065
2021-05-31,WA,Douglas,92,47,139,28516
2021-02-28,WA,Ferry,0,0,0,3625
2021-09-30,WA,Pend Oreille,0,0,0,5690
2021-01-31,WA,Skamania,0,0,0,4017
2018-03-31,WA,Grays Harbor,45,46,91,46091
2018-07-31,CA,Contra Costa,0,1,1,449
2021-04-30,WA,Stevens,40,43,83,30581
2022-03-31,WA,Snohomish,4,0,4,124827
2023-02-28,WA,Yakima,9,0,9,61121
2022-01-31,WA,Pend Oreille,0,0,0,5731
2021-10-31,WA,San Juan,469,146,615,14189
2021-02-28,WA,Cowlitz,194,130,324,71935
2017-08-31,WA,Okanogan,0,0,0,16242
2019-01-31,CA,Tuolumne,0,1,1,12
2020-01-31,WA,Jefferson,0,0,0,9661
2023-05-31,WA,Douglas,7,0,7,12885
2017-04-30,WA,Clallam,0,0,0,20962
2020-03-31,WA,Garfield,0,1,1,1350
2023-06-30,WA,Pierce,163,0,163,135232
2022-06-30,WA,Grant,175,99,274,66817
2022-07-31,WA,Adams,1,0,1,5458
2017-09-30,CA,Marin,1,0,1,59
2019-07-31,WA,Pend Oreille,4,6,10,9537
2018-11-30,CA,Alameda,0,2,2,327
2023-04-30,WA,Columbia,0,0,0,1552
2021-08-31,WA,Clark,3072,1473,4545,322091
2022-03-31,CA,Sacramento,2,0,2,202
2020-09-30,WA,King,5,1,6,183674
2023-02-28,WA,Kitsap,49,0,49,52804
2020-05-31,WA,Jefferson,0,0,0,9510
2018-12-31,WA,Skagit,259,187,446,91196
2023-02-28,WA,Okanogan,107,56,163,26100
2020-03-31,WA,Grant,0,0,0,27056
2018-10-31,WA,Okanogan,15,21,36,26108
2019-02-28,WA,Adams,4,6,10,12671
2021-08-31,WA,Whitman,0,0,0,8572
2021-01-31,CA,Fresno,1,0,1,170
2022-01-31,WA,Columbia,6,2,8,2452
2022-05-31,CA,Sacramento,2,0,2,190
2018-01-31,WA,Mason,65,77,142,44977
2019-12-31,WA,Franklin,54,76,130,60982
2022-07-31,CA,Sonoma,0,1,1,73
2020-10-31,WA,Cowlitz,160,122,282,72100
2021-08-31,WA,Asotin,21,17,38,12728
2017-06-30,WA,Island,0,0,0,20501
2018-05-31,WA,Skamania,0,0,0,3917
2018-08-31,WA,Mason,92,97,189,46050
2020-06-30,WA,Lewis,0,0,0,26209
2021-10-31,WA,Grays Harbor,187,151,338,49486
2021-03-31,WA,Chelan,0,0,0,22987
2023-06-30,WA,Skagit,21,0,21,31455
2023-01-31,WA,King,49761,12517,62278,1334257
2019-10-31,WA,Island,0,0,0,21320
2020-11-30,WA,Yakima,0,0,0,60772
2021-06-30,WA,Walla Walla,0,0,0,14076
2019-10-31,WA,Lewis,108,102,210,59447
2023-05-31,WA,Grays Harbor,290,181,471,48014
2022-09-30,WA,Island,877,382,1259,61751
2021-02-28,WA,Grays Harbor,0,0,0,21251
2020-09-30,WA,Pend Oreille,0,0,0,5727
2018-03-31,CA,Contra Costa,0,1,1,467
2022-01-31,WA,Snohomish,7221,2278,9499,536658
2017-04-30,WA,Pierce,917,807,1724,525754
2022-12-31,WA,Island,17,0,17,21235
2021-08-31,WA,Douglas,0,0,0,12682
2020-05-31,WA,King,5,1,6,181412
2022-08-31,WA,Pend Oreille,18,12,30,9031
2022-05-31,WA,Chelan,450,126,576,54379
2019-04-30,WA,Lewis,0,0,0,25826
2019-02-28,WA,Skagit,1,0,1,32291
2021-04-30,WA,Pacific,0,0,0,7919
2022-01-31,WA,Ferry,0,0,0,3582
2021-05-31,WA,Kitsap,1796,833,2629,180423
2020-12-31,WA,Island,507,289,796,63011
2022-01-31,WA,Spokane,1350,766,2116,326674
2022-07-31,WA,Klickitat,106,56,162,15204
2021-12-31,WA,Douglas,116,56,172,28610
2023-03-31,WA,Mason,11,0,11,20792
2020-01-31,WA,Adams,7,7,14,12913
2019-07-31,CA,Orange,6,1,7,521
2021-10-31,CA,San Francisco,0,1,1,81
2022-12-31,WA,Douglas,169,59,228,28513
2019-09-30,WA,Stevens,27,28,55,31672
2017-01-31,WA,Whitman,0,0,0,8403
2023-02-28,WA,Garfield,1,3,4,1315
2022-06-30,WA,Clark,4095,1781,5876,316688
2023-01-31,CA,Placer,2,0,2,53
2018-07-31,WA,Snohomish,1,0,1,121679
2022-12-31,WA,Whitman,3,0,3,8661
2022-05-31,WA,Columbia,0,0,0,1581
2022-11-30,CA,Riverside,7,0,7,406
2023-01-31,WA,Mason,8,0,8,20880
2020-10-31,WA,Stevens,36,39,75,30368
2022-04-30,WA,Whitman,83,56,139,22051
2021-01-31,WA,Franklin,89,85,174,61500
2022-02-28,WA,King,37216,10526,47742,1354857
2018-09-30,WA,Spokane,359,344,703,305145
2018-05-31,CA,San Diego,7,1,8,2576
2017-12-31,CA,Ventura,0,1,1,328
2018-01-31,WA,Douglas,0,0,0,11790
2017-11-30,WA,Pend Oreille,0,0,0,5595
2023-03-31,WA,Whitman,131,72,203,21998
2020-12-31,WA,Asotin,0,0,0,6675
2023-05-31,CA,Napa,0,1,1,10
2018-09-30,WA,Grays Harbor,0,0,0,20307
2022-07-31,WA,Skamania,0,0,0,3948
2022-11-30,WA,Yakima,6,0,6,61264
2018-11-30,WA,Island,266,224,490,63109
2021-12-31,WA,Walla Walla,143,87,230,36378
2023-03-31,WA,Snohomish,11288,2890,14178,528298
2021-01-31,WA,Walla Walla,103,68,171,36164
2019-11-30,WA,Cowlitz,114,106,220,73591
2022-04-30,WA,Benton,715,446,1161,135499
2020-06-30,WA,Yakima,0,0,0,59894
2021-08-31,WA,Kittitas,173,72,245,29872
2023-05-31,WA,Cowlitz,454,206,660,69496
2020-01-31,WA,Adams,0,0,0,5211
2023-01-31,CA,Ventura,2,1,3,201
2018-05-31,WA,Benton,188,195,383,131301
2018-06-30,WA,Benton,192,199,391,131476
2023-03-31,WA,Yakima,458,238,696,165666
2018-06-30,WA,Skamania,0,0,0,3946
2017-04-30,WA,Benton,143,140,283,128087
2022-06-30,WA,Grays Harbor,1,0,1,21324
2019-04-30,CA,San Francisco,2,1,3,111
2019-07-31,WA,Adams,0,0,0,5132
2019-06-30,WA,Yakima,0,0,0,59138
2020-03-31,CA,San Diego,12,5,17,2781
2019-09-30,CA,San Joaquin,1,0,1,135
2020-08-31,WA,Island,434,273,707,62809
2019-02-28,CA,Alameda,1,2,3,318
2020-04-30,WA,Franklin,58,76,134,60733
2018-09-30,WA,Asotin,11,8,19,12678
2017-03-31,WA,Walla Walla,0,0,0,13186
2020-06-30,WA,Whitman,0,0,0,8508
2017-05-31,WA,Whitman,0,0,0,8394
2019-08-31,WA,San Juan,0,0,0,5891
2021-03-31,WA,Columbia,5,4,9,2466
2022-11-30,WA,Pacific,70,79,149,15759
2017-07-31,WA,Benton,0,0,0,40129
2018-05-31,CA,Contra Costa,0,1,1,451
2023-05-31,CA,Santa Clara,8,1,9,142
2017-12-31,WA,Grant,0,0,0,25587
2019-03-31,WA,Kitsap,997,569,1566,179919
2023-04-30,WA,Whatcom,52,0,52,42622
2021-06-30,CA,Orange,4,3,7,416
2021-03-31,CA,Los Angeles,10,10,20,910
2019-07-31,CA,Kern,0,1,1,218
2022-09-30,WA,Walla Walla,187,105,292,35831
2020-10-31,WA,Skagit,466,231,697,91532
2019-06-30,WA,Walla Walla,49,61,110,36186
2020-05-31,WA,Stevens,34,33,67,30736
2022-03-31,WA,Wahkiakum,18,11,29,3077
2022-02-28,WA,Adams,0,0,0,5459
2020-08-31,WA,Kitsap,1400,699,2099,179638
2023-07-31,WA,Spokane,42,0,42,99373
2023-06-30,WA,Cowlitz,9,0,9,27797
2020-01-31,CA,Ventura,0,3,3,299
2019-02-28,WA,Cowlitz,82,100,182,72440
2022-11-30,WA,Snohomish,79,0,79,122767
2022-05-31,WA,Thurston,4,0,4,55452
2018-08-31,WA,Klickitat,0,0,0,8158
2017-04-30,WA,Island,0,0,0,20526
2019-06-30,WA,Jefferson,0,0,0,9667
2023-07-31,WA,Grant,287,131,418,65201
2022-02-28,CA,Alameda,4,0,4,202
2021-09-30,WA,Wahkiakum,0,0,0,1815
2020-03-31,WA,Klickitat,51,41,92,15597
2020-05-31,WA,Kitsap,0,0,0,53864
2022-05-31,WA,Pierce,4952,2291,7243,546758
2019-02-28,WA,Clark,1337,866,2203,311844
2018-03-31,WA,Lewis,55,47,102,57151
2020-02-29,WA,Columbia,0,0,0,1535
2023-04-30,WA,Pierce,7128,2668,9796,530958
2022-02-28,CA,Sonoma,0,1,1,74
2018-10-31,WA,Wahkiakum,1,1,2,2984
2019-07-31,WA,Grays Harbor,0,0,0,20535
2023-06-30,WA,Skagit,1105,413,1518,87670
2020-06-30,CA,Shasta,1,0,1,36
2021-02-28,WA,San Juan,0,0,0,5867
2018-08-31,WA,Okanogan,0,0,0,16469
2019-10-31,CA,Fresno,1,0,1,191
2021-01-31,WA,Clark,0,0,0,83564
2017-03-31,WA,Klickitat,0,0,0,7941
2020-08-31,WA,Mason,0,0,0,20779
2018-01-31,CA,Los Angeles,5,3,8,1195
2021-10-31,WA,Ferry,0,0,0,3592
2021-11-30,CA,Marin,0,1,1,33
2020-02-29,WA,Thurston,1109,725,1834,198984
2023-06-30,CA,Monterey,1,0,1,98
2020-02-29,WA,Snohomish,0,0,0,123728
2017-12-31,WA,Chelan,0,0,0,21619
2020-06-30,WA,Klickitat,0,0,0,8102
2018-03-31,WA,Kitsap,740,428,1168,176885
2017-07-31,CA,Los Angeles,3,1,4,1271
2020-10-31,WA,Okanogan,0,0,0,16573
2022-01-31,WA,Skagit,1,0,1,32658
2018-07-31,WA,Walla Walla,0,0,0,13467
2019-05-31,WA,Okanogan,0,0,0,16506
2021-06-30,CA,San Joaquin,1,0,1,106
2020-08-31,WA,Walla Walla,0,0,0,13750
2021-02-28,WA,Pierce,0,0,0,145031
2022-08-31,WA,Whitman,2,0,2,8568
2018-02-28,WA,Pierce,1116,1028,2144,526413
2023-01-31,WA,Clallam,499,267,766,49348
2019-08-31,WA,Klickitat,37,35,72,15624
2019-05-31,WA,Franklin,52,70,122,59788
2020-11-30,WA,Island,0,0,0,21304
2020-03-31,WA,Asotin,0,0,0,6667
2019-03-31,WA,Grant,34,55,89,64210
2023-07-31,WA,Douglas,5,0,5,12696
2019-12-31,WA,Kittitas,0,0,0,14624
2018-11-30,CA,Ventura,0,2,2,318
2017-10-31,WA,Ferry,1,1,2,4396
2017-02-28,WA,Stevens,6,21,27,31317
2022-10-31,WA,Island,901,389,1290,61684
2019-01-31,WA,Mason,108,115,223,46659
2022-07-31,WA,Chelan,4,0,4,23054
2020-06-30,WA,Ferry,0,0,0,3555
2022-05-31,CA,Solano,1,0,1,162
2021-11-30,WA,Thurston,0,0,0,56178
2023-04-30,WA,Clallam,518,278,796,48898
2019-03-31,WA,Douglas,53,34,87,27889
2018-11-30,WA,Benton,210,224,434,132792
2019-01-31,WA,Chelan,140,64,204,54205
2019-11-30,WA,Spokane,631,470,1101,314632
2021-05-31,WA,Walla Walla,0,0,0,14041
2018-01-31,WA,Yakima,0,0,0,58106
2023-06-30,WA,Grays Harbor,7,0,7,20684
2023-04-30,WA,Franklin,298,132,430,61650
2017-08-31,WA,Grant,19,32,51,61193
2018-02-28,WA,Okanogan,7,19,26,25665
2022-03-31,WA,Whatcom,1735,695,2430,149237
2021-05-31,WA,Grant,0,0,0,27874
2022-11-30,WA,Kittitas,5,0,5,14582
2021-11-30,WA,Clark,3363,1536,4899,320835
2020-08-31,CA,Santa Cruz,1,0,1,32
2023-01-31,WA,Kitsap,41,0,41,52943
2019-11-30,CA,San Joaquin,1,0,1,135
2017-03-31,WA,Snohomish,1656,849,2505,513393
2020-12-31,WA,Ferry,0,0,0,3607
2022-11-30,WA,Spokane,1896,915,2811,324763
2019-02-28,CA,Santa Clara,8,1,9,367
2019-12-31,CA,San Francisco,2,1,3,100
2019-04-30,WA,Lincoln,3,6,9,7756
2021-07-31,CA,Orange,5,3,8,407
2018-01-31,CA,Ventura,0,1,1,327
2020-11-30,CA,Sacramento,2,0,2,242
2023-07-31,WA,Pacific,78,88,166,15312
2021-05-31,WA,Clallam,321,208,529,50426
2021-09-30,WA,Jefferson,0,0,0,9619
2020-11-30,WA,Garfield,0,1,1,1363
2022-02-28,WA,Cowlitz,280,168,448,71262
2023-07-31,WA,Kittitas,10,0,10,14172
2017-11-30,WA,Spokane,291,239,530,299642
2022-11-30,WA,Jefferson,474,229,703,24392
2022-05-31,WA,Skamania,70,45,115,8209
2022-05-31,WA,Grays Harbor,0,0,0,21307
2019-08-31,CA,Contra Costa,2,2,4,368
2021-04-30,WA,Pierce,0,0,0,145966
2021-08-31,WA,Lincoln,0,0,0,4773
2021-06-30,WA,Skagit,589,274,863,91973
2022-05-31,WA,Whitman,84,58,142,22034
2021-11-30,CA,Los Angeles,10,7,17,832
2017-11-30,WA,Grant,24,33,57,61891
2021-11-30,WA,Lincoln,0,0,0,4811
2018-03-31,WA,Snohomish,2133,1159,3292,517925
2023-06-30,WA,Kittitas,350,103,453,28878
2021-04-30,WA,Spokane,0,0,0,101932
2018-02-28,WA,San Juan,0,0,0,5641
2022-01-31,CA,Kern,0,1,1,195
2019-01-31,WA,Pierce,1581,1423,3004,539770
2017-05-31,WA,Kittitas,22,17,39,27357
2019-05-31,WA,Kitsap,1,0,1,54018
2018-02-28,CA,Ventura,0,1,1,333
2021-06-30,WA,King,6,1,7,184630
2022-09-30,WA,Spokane,12,0,12,101973
2017-12-31,WA,Pacific,15,13,28,15404
2022-05-31,CA,Kings,2,1,3,298
2017-01-31,WA,Island,1,0,1,20520
2017-03-31,WA,Stevens,0,0,0,18309
2022-07-31,WA,Mason,4,0,4,20985
2018-06-30,WA,King,7,1,8,183054
2019-08-31,WA,Chelan,0,0,0,22366
2017-09-30,WA,Franklin,0,0,0,18248
2019-11-30,WA,Douglas,0,0,0,12301
2019-07-31,CA,Santa Cruz,1,0,1,39
2021-10-31,WA,Thurston,0,0,0,56195
2018-09-30,WA,Thurston,0,0,0,54640
2019-03-31,WA,Mason,0,0,0,20274
2020-04-30,WA,Asotin,16,12,28,12444
2022-12-31,WA,Franklin,4,0,4,20986
2019-09-30,WA,Grant,0,0,0,26789
2020-05-31,WA,Ferry,0,0,0,3540
2023-01-31,WA,Pend Oreille,0,0,0,5572
2021-02-28,CA,San Diego,13,5,18,2662
2023-03-31,CA,Santa Cruz,1,0,1,13
2019-02-28,WA,Kitsap,988,571,1559,179782
2020-10-31,CA,Riverside,4,1,5,600
2020-08-31,WA,Garfield,0,1,1,1350
2020-05-31,CA,Placer,2,0,2,87
2021-03-31,WA,Benton,466,369,835,135501
2022-07-31,WA,Clallam,3,0,3,21895
2020-07-31,CA,Placer,2,0,2,85
2020-09-30,WA,Whitman,0,0,0,8497
2020-04-30,WA,Douglas,69,40,109,28017
2022-04-30,WA,Pierce,4836,2264,7100,548921
2023-05-31,WA,Pend Oreille,30,11,41,8845
2022-07-31,WA,Whatcom,11,0,11,43223
2022-03-31,WA,Garfield,0,0,0,999
2018-04-30,CA,San Diego,7,1,8,2553
2017-05-31,CA,Marin,1,0,1,58
2019-06-30,WA,Island,0,0,0,21261
2018-08-31,WA,Franklin,36,65,101,58372
2021-04-30,CA,Fresno,1,0,1,170
2022-11-30,WA,Wahkiakum,1,0,1,1804
2017-11-30,CA,Alameda,0,1,1,353
2021-09-30,WA,Clallam,359,229,588,50550
2018-06-30,WA,Klickitat,0,0,0,8117
2017-09-30,WA,Whatcom,2,0,2,41837
2022-12-31,CA,Alameda,3,0,3,158
2019-01-31,WA,Douglas,0,0,0,12172
2018-02-28,WA,Kitsap,1,0,1,52833
2022-10-31,WA,Douglas,2,0,2,12811
2023-01-31,WA,Lincoln,14,19,33,7764
2019-04-30,WA,Franklin,0,0,0,19218
2019-10-31,WA,Chelan,191,75,266,54655
2021-05-31,WA,Okanogan,61,37,98,26414
2018-07-31,CA,Marin,1,0,1,55
2022-03-31,WA,Grant,0,0,0,28046
2020-06-30,WA,Wahkiakum,6,6,12,2991
2023-01-31,WA,Skagit,11,0,11,32085
2018-11-30,WA,Franklin,38,64,102,58943
2023-04-30,WA,Whitman,4,0,4,8571
2019-09-30,WA,Columbia,3,2,5,2446
2017-12-31,WA,Skamania,0,0,0,3896
2021-12-31,WA,Okanogan,69,45,114,26600
2019-10-31,WA,Skamania,25,20,45,8803
2018-09-30,WA,Douglas,0,0,0,12012
2020-09-30,CA,Ventura,1,2,3,272
2022-05-31,WA,Franklin,181,110,291,62027
2020-09-30,WA,Grays Harbor,0,0,0,21093
2017-09-30,WA,Klickitat,0,0,0,7988
2022-02-28,WA,Snohomish,7454,2311,9765,535946
2021-07-31,WA,Clark,2977,1459,4436,322390
2022-04-30,WA,Grant,159,98,257,66893
2017-09-30,WA,Grays Harbor,38,38,76,45132
2023-07-31,WA,Thurston,64,0,64,52520
2021-05-31,WA,San Juan,0,0,0,5926
2019-04-30,WA,Franklin,53,67,120,59469
2018-01-31,WA,Pierce,0,0,0,137147
2018-11-30,WA,Walla Walla,0,0,0,13518
2019-01-31,CA,Contra Costa,1,2,3,405
2017-04-30,WA,Kittitas,0,0,0,13478
2022-09-30,WA,Kitsap,23,0,23,53242
2022-02-28,WA,Okanogan,0,0,0,16714
2021-08-31,WA,Cowlitz,0,1,1,29085
2019-09-30,CA,Contra Costa,2,2,4,367
2023-07-31,CA,Santa Clara,8,1,9,127
2021-04-30,WA,San Juan,0,0,0,5911
2020-02-29,WA,Chelan,0,0,0,22573
2022-05-31,WA,Skagit,2,0,2,32401
2018-10-31,WA,Pend Oreille,0,0,0,5752
2018-06-30,WA,Grays Harbor,52,58,110,46575
2020-07-31,WA,San Juan,311,94,405,13959
2020-06-30,CA,Orange,7,2,9,492
2017-05-31,CA,Tulare,1,0,1,193
2018-10-31,WA,Kittitas,57,35,92,29279
2021-04-30,WA,Lewis,146,135,281,59779
2018-07-31,CA,Orange,4,1,5,553
2022-12-31,WA,Kittitas,301,93,394,29550
2020-05-31,WA,Adams,0,0,0,5217
2020-11-30,WA,Lincoln,0,0,0,4660
2018-11-30,WA,Pacific,20,23,43,15810
2018-05-31,WA,Franklin,38,63,101,57692
2017-05-31,WA,Lincoln,2,5,7,7507
2018-12-31,CA,Santa Clara,8,1,9,372
2020-12-31,WA,Whatcom,3,0,3,43545
2021-10-31,CA,Contra Costa,1,4,5,264
2019-03-31,WA,Yakima,0,0,0,58746
2022-04-30,WA,Klickitat,0,0,0,8281
2018-06-30,WA,Walla Walla,0,0,0,13416
2021-09-30,WA,Whitman,64,56,120,21929
2017-01-31,WA,Whatcom,383,141,524,141886
2022-05-31,WA,Klickitat,1,0,1,8293
2023-07-31,CA,Contra Costa,0,3,3,172
2018-05-31,WA,Spokane,324,302,626,302459
2019-05-31,WA,Island,315,234,549,63346
2019-10-31,WA,Whatcom,2,0,2,43096
2021-11-30,WA,Okanogan,67,43,110,26601
2022-11-30,WA,Skamania,0,0,0,3892
2022-05-31,WA,Grant,0,0,0,27995
2020-07-31,WA,Clallam,1,0,1,21697
2022-12-31,WA,Chelan,536,143,679,54270
2022-08-31,WA,Cowlitz,2,0,2,28458
2020-08-31,WA,Whitman,46,48,94,22021
2021-08-31,WA,Lincoln,7,15,22,7695
2017-04-30,CA,San Mateo,0,1,1,158
2020-09-30,CA,Solano,1,0,1,205
2019-07-31,WA,Spokane,1,0,1,95241
2017-06-30,WA,Adams,0,0,0,5106
2021-03-31,CA,Monterey,0,1,1,147
2020-04-30,WA,Jefferson,0,0,0,9531
2020-06-30,WA,Douglas,71,40,111,28002
2022-01-31,WA,Whitman,0,0,0,8565
2019-11-30,WA,Ferry,0,0,0,3581
2019-08-31,WA,King,20005,7202,27207,1393126
2022-06-30,CA,Orange,5,2,7,338
2021-01-31,WA,Skagit,1,0,1,32861
2023-04-30,WA,Lewis,6,0,6,26003
2018-07-31,WA,Wahkiakum,1,1,2,2938
2018-01-31,WA,Lincoln,2,5,7,7587
2018-11-30,CA,San Francisco,2,1,3,118
2017-08-31,WA,Douglas,35,27,62,26835
2022-01-31,CA,San Luis Obispo,1,0,1,55
2020-11-30,WA,Spokane,0,0,0,100377
2018-10-31,WA,Ferry,0,0,0,3566
2017-10-31,WA,Pacific,0,0,0,7521
2018-01-31,WA,Kitsap,706,402,1108,176404
2022-04-30,WA,Stevens,64,52,116,30125
2022-03-31,WA,Franklin,0,0,0,20940
2023-03-31,CA,Napa,0,1,1,10
2021-10-31,CA,Santa Clara,7,2,9,237
2019-05-31,WA,Pacific,0,0,0,7661
2020-02-29,WA,Benton,0,0,0,42572
2023-01-31,CA,Monterey,1,1,2,113
2021-07-31,WA,Pend Oreille,0,0,0,5747
2018-11-30,WA,Jefferson,169,104,273,24795
2023-05-31,CA,Placer,1,0,1,50
2017-01-31,WA,Whatcom,2,0,2,41337
2017-06-30,WA,Yakima,45,57,102,159401
2020-01-31,WA,Skamania,29,19,48,8769
2019-06-30,WA,Columbia,2,2,4,2450
2020-06-30,WA,Grays Harbor,0,0,0,20910
2018-12-31,WA,Klickitat,0,0,0,8209
2022-12-31,WA,Thurston,2627,1134,3761,192301
2022-01-31,WA,Wahkiakum,17,11,28,3075
2018-06-30,WA,Pacific,0,0,0,7600
2021-12-31,WA,Skagit,695,302,997,91135
2019-04-30,WA,San Juan,204,69,273,14332
2018-01-31,WA,Snohomish,1,0,1,121550
2020-03-31,WA,Chelan,0,0,0,22551
2023-07-31,WA,Skamania,1,0,1,3727
2022-05-31,WA,Island,1,0,1,21433
2017-01-31,WA,Island,103,119,222,59416
2020-07-31,WA,Kitsap,1377,696,2073,179884
2019-10-31,WA,Kittitas,87,45,132,29964
2018-01-31,WA,Columbia,0,0,0,1545
2023-04-30,WA,Lincoln,0,0,0,4841
2018-02-28,WA,Lewis,52,45,97,56859
2021-05-31,WA,Jefferson,322,181,503,24893
2019-11-30,WA,Grays Harbor,99,99,198,48351
2020-11-30,WA,Skamania,0,0,0,4008
2023-03-31,WA,Benton,16,0,16,43262
2017-04-30,WA,Skagit,123,97,220,87597
2020-09-30,WA,Wahkiakum,0,0,0,1759
2017-04-30,WA,Stevens,0,0,0,18286
2021-09-30,WA,Grays Harbor,183,150,333,49489
2022-07-31,WA,Mason,320,176,496,47125
2020-07-31,WA,Adams,9,7,16,12866
2018-11-30,WA,Snohomish,1,0,1,121952
2017-04-30,WA,Cowlitz,0,0,0,27856
2020-05-31,WA,Kittitas,0,0,0,14554
2018-01-31,WA,Grays Harbor,42,42,84,45972
2017-12-31,WA,Lewis,0,0,0,25311
2018-07-31,WA,Clallam,0,0,0,21477
2018-11-30,WA,Garfield,0,0,0,964
2023-05-31,WA,King,55335,14137,69472,1316224
2017-04-30,WA,Snohomish,1709,861,2570,512767
2019-07-31,WA,Grays Harbor,82,85,167,47997
2021-11-30,WA,Clallam,372,238,610,50508
2019-07-31,WA,Ferry,5,2,7,4399
2019-05-31,WA,Pierce,0,0,0,139646
2021-11-30,CA,Sacramento,2,0,2,216
2020-05-31,CA,San Francisco,1,1,2,96
2023-05-31,WA,Asotin,0,0,0,6599
2022-12-31,WA,Asotin,0,0,0,6686
2023-05-31,WA,Skagit,19,0,19,31695
2020-09-30,WA,Skamania,32,22,54,8373
2017-03-31,WA,King,8,1,9,189758
2021-04-30,WA,Chelan,314,93,407,54673
2022-10-31,WA,Wahkiakum,24,12,36,3064
2022-11-30,WA,Pend Oreille,19,13,32,8989
2018-11-30,WA,Okanogan,0,0,0,16492
2017-10-31,WA,Whatcom,510,202,712,144316
2018-01-31,WA,San Juan,137,46,183,13927
2019-02-28,WA,Asotin,0,0,0,6644
2022-11-30,WA,Columbia,8,1,9,2431
2022-07-31,WA,Adams,19,10,29,12942
2023-06-30,WA,Chelan,31,0,31,22830
2021-08-31,WA,Ferry,0,0,0,3632
2019-01-31,WA,Wahkiakum,0,0,0,1711
2020-01-31,WA,Wahkiakum,0,0,0,1759
2023-04-30,WA,Snohomish,145,0,145,121227
2017-10-31,WA,Douglas,36,32,68,26967
2023-03-31,WA,Jefferson,522,247,769,24231
2023-04-30,WA,Chelan,26,0,26,23050
2018-05-31,WA,Pierce,0,0,0,137544
2018-06-30,WA,Wahkiakum,0,0,0,1675
2020-11-30,WA,Pend Oreille,9,4,13,9146
2023-05-31,WA,Clark,5619,2279,7898,311557
2020-06-30,WA,Grant,59,71,130,65239
2021-06-30,WA,Benton,0,0,0,43627
2019-05-31,WA,King,5,1,6,181939
2021-11-30,WA,Spokane,0,0,0,102699
2020-06-30,WA,Lincoln,0,0,0,4624
2020-03-31,WA,Ferry,0,0,0,3565
2018-04-30,WA,Klickitat,24,29,53,15050
2020-09-30,WA,Mason,162,131,293,47460
2022-10-31,WA,Thurston,2467,1109,3576,192794
2019-06-30,CA,San Francisco,2,1,3,105
2021-03-31,WA,Pend Oreille,0,0,0,5724
2022-11-30,WA,Snohomish,9877,2716,12593,530771
2020-01-31,WA,Lincoln,0,0,0,4671
2023-02-28,CA,Kings,2,1,3,273
2021-04-30,WA,Kittitas,0,0,0,14775
2017-01-31,WA,Mason,0,0,0,19187
2018-09-30,WA,Spokane,1,0,1,93185
2023-05-31,WA,Kittitas,8,0,8,14448
2023-04-30,WA,Grays Harbor,286,182,468,48238
2018-12-31,WA,Lincoln,2,5,7,7780
2017-03-31,WA,Walla Walla,20,22,42,34821
2017-09-30,WA,Ferry,1,1,2,4380
2021-09-30,WA,King,32879,9690,42569,1365552
2020-08-31,WA,Ferry,7,3,10,4309
2018-10-31,WA,Clark,1149,814,1963,310425
2018-07-31,WA,Chelan,112,52,164,53574
2023-07-31,WA,Whatcom,2522,891,3413,144372
2021-01-31,WA,Snohomish,1,0,1,125692
2019-11-30,WA,Franklin,0,0,0,19729
2018-09-30,WA,Whitman,0,0,0,8517
2021-11-30,WA,Whitman,0,0,0,8556
2023-02-28,WA,Thurston,2773,1153,3926,191440
2017-08-31,WA,Cowlitz,50,62,112,70013
2021-12-31,CA,Orange,5,2,7,376
2020-10-31,WA,Grant,71,81,152,65747
2021-12-31,WA,Ferry,0,0,0,3596
2022-02-28,WA,Chelan,429,121,550,54566
2022-10-31,WA,Grays Harbor,231,166,397,48742
2019-06-30,WA,Walla Walla,0,0,0,13593
2021-12-31,WA,Skamania,0,0,0,4002
2022-07-31,CA,Sacramento,3,0,3,188
2022-03-31,WA,Yakima,312,181,493,167703
2022-11-30,WA,Klickitat,3,0,3,8251
2019-12-31,WA,Mason,142,135,277,47637
2022-12-31,WA,Mason,370,191,561,46879
2023-06-30,WA,Whatcom,58,0,58,42106
2017-02-28,WA,Pacific,0,0,0,7486
2022-09-30,WA,Jefferson,454,224,678,24444
2017-05-31,WA,Douglas,32,23,55,26684
2023-06-30,WA,Walla Walla,219,111,330,34992
2021-12-31,CA,San Francisco,0,1,1,81
2021-07-31,WA,Whatcom,1475,618,2093,150663
2019-08-31,WA,Clark,0,0,0,80861
2023-01-31,WA,Spokane,1998,953,2951,324493
2018-11-30,WA,Grant,32,52,84,64032
2017-08-31,CA,San Mateo,0,1,1,150
2021-05-31,WA,Snohomish,1,0,1,126365
2023-01-31,WA,Pierce,6394,2548,8942,537638
2023-06-30,WA,Clark,97,0,97,80308
2017-01-31,WA,Kittitas,0,0,0,13412
2019-02-28,WA,Lincoln,3,5,8,7735
2023-04-30,CA,Los Angeles,4,5,9,585
2022-02-28,WA,Lewis,221,166,387,59453
2019-08-31,WA,Pend Oreille,0,0,0,5721
2018-05-31,WA,King,7,1,8,183157
2021-12-31,WA,Stevens,55,44,99,30290
2022-05-31,WA,Garfield,0,3,3,1329
2021-03-31,WA,Cowlitz,197,133,330,72161
2021-07-31,CA,Sonoma,0,1,1,79
2023-04-30,WA,Stevens,1,0,1,18709
2022-10-31,WA,Island,14,0,14,21277
2018-09-30,WA,Thurston,621,527,1148,194606
2020-03-31,CA,Tuolumne,0,1,1,10
2019-02-28,WA,Pacific,22,26,48,15864
2019-07-31,WA,Kittitas,0,0,0,14488
2021-02-28,WA,Cowlitz,0,0,0,28976
2019-12-31,WA,San Juan,253,79,332,14407
2019-08-31,WA,Whatcom,2,0,2,42997
2018-08-31,WA,Kittitas,51,34,85,29121
2017-04-30,CA,Riverside,1,1,2,829
2017-10-31,WA,Clallam,96,85,181,48722
2017-02-28,WA,Skamania,7,7,14,8543
2023-06-30,WA,Douglas,209,64,273,28488
2020-08-31,WA,Island,1,0,1,21228
2022-03-31,WA,Spokane,0,0,0,102463
2023-07-31,WA,Franklin,315,141,456,60118
2021-04-30,WA,Wahkiakum,11,6,17,3113
2019-09-30,WA,Skagit,1,0,1,32515
2022-11-30,WA,Franklin,3,0,3,20955
2021-11-30,WA,Chelan,400,113,513,54703
2021-05-31,WA,Grant,102,87,189,66863
2020-03-31,WA,Chelan,220,79,299,54482
2019-01-31,WA,Stevens,18,28,46,31816
2020-06-30,WA,Kittitas,0,0,0,14591
2020-10-31,WA,Jefferson,0,0,0,9575
2017-09-30,WA,Kittitas,0,0,0,13657
2021-10-31,WA,Walla Walla,0,0,0,14050
2022-07-31,WA,Pend Oreille,0,0,0,5648
2023-01-31,CA,Napa,0,1,1,9
2019-01-31,WA,Skagit,270,186,456,91360
2020-03-31,WA,Columbia,3,3,6,2416
2021-07-31,WA,Grays Harbor,176,146,322,49519
2017-11-30,CA,Sacramento,1,0,1,317
2020-01-31,WA,Jefferson,224,139,363,25209
2018-10-31,WA,Lewis,88,70,158,58040
2018-07-31,WA,Spokane,347,320,667,304017
2022-08-31,WA,Snohomish,45,0,45,123227
2022-11-30,WA,Clallam,8,0,8,21885
2018-06-30,WA,San Juan,0,0,0,5713
2019-02-28,WA,Mason,0,0,0,20229
2018-09-30,CA,San Francisco,1,1,2,117
2021-07-31,WA,Ferry,0,0,0,3646
2019-10-31,WA,Columbia,0,0,0,1533
2022-11-30,CA,Marin,0,1,1,29
2018-10-31,WA,Clark,0,0,0,79579
2019-10-31,WA,Klickitat,0,0,0,8311
2019-09-30,WA,Wahkiakum,0,0,0,1760
2018-07-31,WA,Columbia,2,2,4,2419
2019-08-31,WA,Grays Harbor,88,85,173,48116
2020-10-31,WA,Pend Oreille,0,0,0,5717
2018-07-31,WA,Clark,0,0,0,79240
2018-10-31,WA,King,15034,6221,21255,1376342
2023-02-28,WA,Columbia,8,1,9,2424
2023-01-31,WA,Asotin,0,0,0,6681
2020-04-30,WA,Adams,7,7,14,12756
2020-11-30,CA,Contra Costa,4,3,7,284
2023-02-28,WA,Franklin,275,128,403,61808
2023-03-31,WA,Franklin,284,129,413,61766
2017-07-31,WA,San Juan,112,39,151,13563
2019-03-31,WA,Pacific,0,0,0,7655
2019-10-31,WA,Lewis,0,0,0,26045
2017-02-28,WA,Yakima,0,0,0,57223
2021-09-30,CA,Monterey,0,1,1,143
2021-09-30,WA,Benton,581,414,995,136268
2022-08-31,CA,Los Angeles,7,7,14,717
2020-06-30,WA,Clallam,1,0,1,21760
2022-12-31,CA,Contra Costa,0,3,3,209
2022-10-31,CA,Marin,0,1,1,28
2022-12-31,WA,Franklin,252,120,372,61769
2023-01-31,WA,Klickitat,127,53,180,15178
2019-03-31,WA,Grays Harbor,0,0,0,20376
2023-02-28,CA,Kern,1,1,2,182
2023-03-31,CA,Contra Costa,0,3,3,196
2020-08-31,WA,Pend Oreille,8,5,13,9230
2021-08-31,CA,Contra Costa,2,4,6,260
2022-12-31,CA,Kern,1,1,2,187
2022-02-28,CA,Solano,1,0,1,169
2017-08-31,WA,Grays Harbor,0,0,0,19935
2017-01-31,WA,Garfield,0,0,0,1285
2017-07-31,WA,Ferry,1,1,2,4400
2020-08-31,WA,Yakima,0,0,0,60420
2018-12-31,WA,Pierce,1509,1373,2882,538890
2018-12-31,WA,Walla Walla,0,0,0,13523
2023-07-31,CA,Kern,1,1,2,154
2019-07-31,WA,Wahkiakum,0,0,0,1761
2020-08-31,WA,Skagit,432,222,654,91256
2019-12-31,WA,Benton,315,308,623,135242
2021-11-30,WA,King,6,1,7,183330
2020-01-31,WA,Whitman,0,0,0,8567
2020-12-31,WA,Mason,173,133,306,47648
2020-05-31,WA,Island,1,0,1,21136
2021-10-31,CA,Alameda,4,0,4,212
2021-05-31,WA,Spokane,0,0,0,102090
2017-08-31,WA,San Juan,0,0,0,5549
2019-04-30,WA,Douglas,55,34,89,27972
2021-09-30,WA,Pacific,0,0,0,7998
2020-01-31,CA,Santa Clara,7,2,9,343
2022-12-31,WA,Klickitat,123,51,174,15155
2023-04-30,CA,Alameda,3,0,3,149
2020-05-31,WA,Lincoln,0,0,0,4618
2022-12-31,CA,Los Angeles,5,6,11,655
2020-03-31,WA,Stevens,0,0,0,18700
2019-06-30,WA,King,5,1,6,182076
2017-12-31,CA,Riverside,1,2,3,739
2023-03-31,WA,Clallam,507,275,782,49127
2020-09-30,WA,Lewis,111,117,228,58309
2018-02-28,WA,Snohomish,1,0,1,121335
2020-02-29,CA,Santa Clara,7,2,9,334
2017-04-30,CA,Alameda,2,1,3,379
2019-01-31,WA,Lincoln,2,5,7,7755
2020-05-31,CA,Fresno,1,0,1,183
2023-04-30,WA,Kittitas,8,0,8,14470
2023-04-30,WA,Jefferson,531,253,784,24161
2021-09-30,CA,Riverside,4,1,5,522
2020-10-31,WA,King,5,1,6,184061
2019-11-30,WA,Chelan,0,0,0,22517
2022-03-31,WA,Pacific,61,68,129,15997
2021-01-31,CA,San Diego,13,5,18,2686
2017-01-31,WA,Chelan,0,0,0,21262
2020-08-31,CA,Placer,2,0,2,84
2018-09-30,CA,Ventura,0,2,2,311
2020-04-30,WA,Skagit,397,215,612,91480
2021-08-31,WA,Pend Oreille,16,7,23,9243
2017-09-30,CA,Alameda,0,1,1,351
2022-11-30,WA,Okanogan,2,0,2,16474
2020-06-30,WA,Clallam,228,168,396,50092
2018-06-30,WA,Franklin,39,66,105,57858
2023-02-28,WA,Franklin,4,0,4,20960
2019-03-31,WA,Cowlitz,84,101,185,72544
2018-06-30,WA,Clark,0,0,0,79122
2020-08-31,WA,Clark,0,0,0,82716
2019-12-31,WA,Walla Walla,63,60,123,36306
2017-04-30,WA,Ferry,2,1,3,4397
2022-07-31,WA,Asotin,0,0,0,6688
2021-12-31,WA,Pacific,0,0,0,8019
2019-01-31,WA,Spokane,471,380,851,307611
2019-06-30,WA,Kittitas,81,38,119,29608
2019-08-31,WA,Wahkiakum,2,2,4,3026
2019-01-31,WA,Whitman,0,0,0,8512
2019-03-31,WA,Skamania,21,15,36,8722
2018-08-31,WA,Lincoln,0,0,0,4572
2018-08-31,CA,Alameda,0,1,1,340
2017-12-31,WA,Whitman,0,0,0,8450
2019-01-31,WA,Garfield,0,0,0,962
2020-03-31,WA,Spokane,1,0,1,97458
2019-05-31,CA,Tuolumne,0,1,1,12
2018-02-28,WA,King,8,1,9,184086
2019-03-31,CA,Contra Costa,1,2,3,394
2021-07-31,CA,San Joaquin,1,0,1,101
2023-01-31,WA,Adams,1,0,1,5377
2020-12-31,WA,Grant,80,81,161,65927
2020-09-30,CA,Contra Costa,4,3,7,296
2018-10-31,WA,Garfield,1,1,2,1330
2020-05-31,WA,Pend Oreille,7,6,13,9217
2017-11-30,WA,Asotin,0,0,0,6552
2018-05-31,CA,Orange,4,1,5,562
2019-05-31,WA,Pend Oreille,4,5,9,9537
2021-09-30,WA,Okanogan,67,44,111,26541
2023-01-31,WA,Yakima,8,0,8,61183
2021-06-30,CA,El Dorado,1,0,1,31
2017-02-28,CA,Contra Costa,1,0,1,653
2017-04-30,WA,Kitsap,584,298,882,172672
2017-08-31,WA,King,10441,4267,14708,1372396
2017-02-28,WA,Spokane,1,0,1,90241
2022-01-31,WA,Grays Harbor,0,0,0,21347
2022-03-31,CA,San Luis Obispo,1,0,1,55
2020-04-30,CA,San Joaquin,1,0,1,130
2020-10-31,WA,Pend Oreille,8,4,12,9158
2018-05-31,CA,Alameda,0,1,1,348
2023-06-30,WA,Yakima,13,0,13,60023
2021-02-28,WA,Douglas,0,0,0,12517
2020-07-31,CA,Contra Costa,4,3,7,305
2021-01-31,WA,Chelan,294,87,381,54481
2022-10-31,WA,Okanogan,95,49,144,26284
2023-06-30,WA,Okanogan,123,63,186,25802
2022-01-31,WA,Lincoln,6,17,23,7738
2022-02-28,WA,Spokane,0,0,0,102602
2022-01-31,CA,Ventura,2,1,3,237
2020-10-31,WA,Snohomish,0,0,0,125318
2018-02-28,WA,Walla Walla,0,0,0,13323
2022-09-30,WA,Pierce,46,0,46,140496
2021-10-31,WA,Skagit,1,0,1,32836
2019-10-31,WA,Walla Walla,0,0,0,13670
2021-04-30,WA,Mason,0,0,0,21291
2018-02-28,WA,San Juan,140,48,188,13922
2017-05-31,WA,Mason,0,0,0,19265
2020-10-31,WA,Benton,403,339,742,134682
2021-04-30,WA,Skamania,0,0,0,4022
2018-01-31,WA,Whitman,0,0,0,8472
2021-03-31,WA,Skamania,38,25,63,8308
2018-10-31,WA,Asotin,12,9,21,12713
2018-01-31,WA,Clallam,106,95,201,49281
2017-12-31,WA,Klickitat,23,26,49,14902
2020-01-31,WA,Walla Walla,65,61,126,36352
2019-04-30,WA,Jefferson,0,0,0,9652
2021-02-28,WA,Garfield,0,2,2,1356
2020-10-31,WA,Jefferson,260,151,411,24723
2023-05-31,WA,Pacific,3,0,3,7785
2018-06-30,WA,Whitman,0,0,0,8493
2018-04-30,WA,King,7,1,8,183356
2020-09-30,WA,Whatcom,3,0,3,43388
2021-10-31,WA,Yakima,0,0,0,61670
2019-01-31,WA,Ferry,0,0,0,3590
2019-01-31,CA,San Mateo,2,1,3,126
2023-05-31,CA,Solano,5,0,5,132
2019-01-31,WA,Spokane,1,0,1,93943
2022-05-31,WA,Snohomish,8141,2474,10615,533059
2019-04-30,WA,Snohomish,3292,1539,4831,529161
2022-09-30,WA,Pend Oreille,18,12,30,9024
2019-05-31,WA,Spokane,1,0,1,94607
2019-09-30,WA,Okanogan,0,0,0,16497
2022-12-31,WA,Kitsap,2765,1146,3911,177328
2022-09-30,WA,Clallam,442,249,691,49482
2018-09-30,WA,Pacific,0,0,0,7632
2018-10-31,WA,Kitsap,880,507,1387,179926
2018-11-30,CA,Contra Costa,0,2,2,416
2020-05-31,WA,Pierce,2351,1675,4026,547592
2019-09-30,WA,Benton,291,297,588,134616
2022-10-31,WA,Pacific,68,74,142,15756
2020-03-31,WA,Whitman,42,46,88,22485
2021-06-30,WA,Skamania,44,34,78,8407
2017-06-30,WA,Kittitas,21,17,38,27579
2022-04-30,WA,Okanogan,0,0,0,16687
2021-06-30,WA,Thurston,1585,872,2457,198143
2020-01-31,CA,San Joaquin,1,0,1,136
2018-08-31,WA,Ferry,0,0,0,3550
2022-04-30,WA,Garfield,0,0,0,990
2022-12-31,WA,Yakima,425,218,643,166458
2018-06-30,WA,Cowlitz,0,0,0,28460
2022-10-31,WA,Pacific,1,0,1,7875
2020-02-29,WA,Walla Walla,68,62,130,36314
2021-11-30,WA,Island,0,0,0,21547
2020-01-31,CA,Contra Costa,3,2,5,336
2022-02-28,WA,Yakima,0,0,0,61654
2019-01-31,CA,Orange,5,2,7,538
2020-12-31,WA,Douglas,86,44,130,28191
2022-01-31,WA,Asotin,23,17,40,12668
2022-08-31,WA,Whitman,94,62,156,22009
2021-04-30,WA,Pacific,41,41,82,16071
2021-01-31,WA,Jefferson,290,166,456,24802
2022-11-30,WA,Okanogan,98,51,149,26251
2018-03-31,WA,Okanogan,7,19,26,25733
2020-07-31,WA,Pend Oreille,0,0,0,5762
2017-09-30,CA,Tulare,1,0,1,197
2017-01-31,WA,Benton,0,0,0,39813
2023-03-31,WA,Thurston,52,0,52,54221
2018-09-30,WA,Pend Oreille,0,0,0,5744
2021-09-30,WA,Asotin,0,0,0,6755
2023-02-28,WA,Pierce,111,0,111,138554
2022-12-31,CA,Riverside,7,0,7,390
2019-01-31,WA,Kitsap,1,0,1,53730
2019-03-31,WA,San Juan,197,70,267,14290
2021-03-31,WA,Asotin,0,0,0,6725
2022-05-31,WA,Ferry,20,4,24,4434
2018-12-31,WA,Spokane,439,373,812,307178
2021-10-31,WA,Adams,16,14,30,13034
2018-05-31,WA,Stevens,0,0,0,18590
2020-03-31,WA,Wahkiakum,0,0,0,1760
2022-10-31,WA,Adams,1,0,1,5429
2018-01-31,WA,Whatcom,548,238,786,145510
2023-07-31,CA,Monterey,1,0,1,94
2019-07-31,WA,Mason,0,0,0,20412
2020-03-31,WA,Pacific,0,0,0,7711
2019-07-31,CA,San Francisco,2,1,3,105
2017-04-30,WA,Douglas,0,0,0,11451
2021-08-31,CA,Kings,1,0,1,321
2020-12-31,WA,Clallam,273,185,458,49921
2022-06-30,CA,Solano,1,0,1,157
2019-02-28,WA,Chelan,145,66,211,54157
2021-12-31,WA,Kittitas,207,75,282,29844
2020-02-29,CA,Los Angeles,8,11,19,1039
2022-05-31,WA,Mason,1,0,1,21058
2017-03-31,WA,Franklin,26,47,73,55311
2018-11-30,WA,Klickitat,23,32,55,15421
2022-01-31,CA,Contra Costa,1,4,5,255
2019-07-31,WA,Okanogan,0,0,0,16490
2020-07-31,WA,Columbia,4,3,7,2418
2022-10-31,WA,Columbia,0,0,0,1583
2019-09-30,WA,Adams,5,5,10,12887
2020-05-31,WA,Thurston,1136,733,1869,196825
2019-04-30,WA,Adams,0,0,0,5104
2020-10-31,WA,Mason,0,0,0,20836
2022-04-30,WA,Snohomish,7965,2418,10383,534060
2021-11-30,WA,Adams,16,14,30,13044
2022-01-31,CA,Santa Cruz,1,0,1,23
2020-05-31,WA,King,24017,7688,31705,1374959
2021-05-31,WA,King,30043,8922,38965,1368667
2022-03-31,WA,Yakima,0,0,0,61589
2019-04-30,WA,Ferry,0,0,0,3592
2021-04-30,CA,Kern,0,1,1,213
2023-04-30,CA,Sacramento,4,0,4,134
2017-03-31,WA,Skamania,8,8,16,8529
2021-01-31,CA,El Dorado,1,0,1,32
2019-06-30,WA,Lincoln,2,8,10,7776
2019-05-31,WA,Clark,0,0,0,80186
2017-03-31,WA,Garfield,0,0,0,1283
2023-01-31,CA,Kings,2,1,3,273
2020-01-31,WA,Ferry,0,0,0,3586
2023-03-31,WA,Wahkiakum,2,0,2,1779
2021-05-31,WA,Skamania,43,32,75,8395
2021-02-28,CA,Monterey,0,1,1,149
2019-02-28,WA,Grant,33,55,88,64279
2021-04-30,CA,El Dorado,1,0,1,31
2017-07-31,WA,Snohomish,1,0,1,121771
2019-08-31,WA,Columbia,0,0,0,1531
2022-12-31,WA,Grant,230,112,342,66890
2020-08-31,WA,Wahkiakum,6,6,12,3028
2017-03-31,CA,San Diego,5,1,6,2806
2018-04-30,CA,Orange,3,1,4,568
2017-06-30,WA,Columbia,1,1,2,2353
2023-07-31,WA,Whatcom,63,0,63,41534
2020-04-30,WA,Whatcom,1058,490,1548,150136
2018-06-30,WA,Asotin,0,0,0,6616
2018-02-28,WA,Stevens,10,21,31,31515
2020-06-30,WA,Garfield,0,1,1,1351
2017-12-31,CA,San Diego,6,1,7,2563
2019-12-31,CA,Orange,7,2,9,504
2023-01-31,WA,Franklin,4,0,4,20981
2023-02-28,WA,Pacific,2,0,2,7825
2017-09-30,WA,Adams,0,0,0,5123
2022-03-31,WA,Asotin,22,18,40,12658
2018-03-31,CA,Marin,1,0,1,54
2017-10-31,WA,Kitsap,661,355,1016,174891
2022-04-30,WA,Skamania,67,46,113,8227
2017-07-31,WA,Klickitat,22,24,46,14803
2023-01-31,WA,San Juan,572,173,745,13878
2021-07-31,CA,El Dorado,1,0,1,30
2018-04-30,WA,King,12284,5290,17574,1368427
2022-07-31,WA,Island,835,380,1215,61863
2017-07-31,WA,Adams,3,3,6,12184
2019-05-31,WA,Walla Walla,46,57,103,36164
2019-12-31,WA,Lincoln,1,11,12,7804
2021-11-30,WA,Franklin,154,103,257,62279
2022-04-30,WA,Grays Harbor,200,158,358,49216
2019-07-31,WA,Island,328,243,571,63488
2023-07-31,CA,Kings,2,1,3,242
2017-04-30,WA,Wahkiakum,0,0,0,1631
2021-11-30,WA,Skagit,667,299,966,91301
2022-11-30,WA,Walla Walla,3,0,3,13912
2022-04-30,WA,Ferry,19,4,23,4406
2020-08-31,WA,Ferry,0,0,0,3582
2021-01-31,WA,Pacific,35,37,72,15798
2023-04-30,WA,Columbia,8,1,9,2407
2019-10-31,WA,Whitman,38,45,83,22717
2023-05-31,WA,Kittitas,339,102,441,29165
2021-04-30,WA,Lincoln,5,13,18,7751
2020-02-29,WA,Pacific,0,0,0,7745
2020-10-31,CA,San Diego,14,4,18,2724
2018-10-31,WA,Klickitat,0,0,0,8154
2021-02-28,WA,Mason,0,0,0,21053
2021-05-31,WA,Pacific,43,47,90,16070
2020-11-30,CA,Los Angeles,9,10,19,957
2022-10-31,CA,Orange,5,2,7,308
2022-08-31,CA,Kern,0,1,1,187
2018-10-31,CA,San Francisco,1,1,2,115
2021-11-30,WA,Ferry,13,3,16,4457
2017-05-31,WA,Cowlitz,52,50,102,69536
2020-03-31,WA,Kittitas,98,49,147,29998
2020-11-30,WA,Lincoln,5,11,16,7617
2019-04-30,WA,Skagit,292,197,489,91537
2022-12-31,CA,Kings,2,1,3,276
2023-06-30,CA,Placer,1,0,1,50
2021-02-28,CA,Solano,1,0,1,195
2017-12-31,WA,Walla Walla,29,32,61,35287
2019-07-31,WA,Stevens,0,0,0,18704
2022-08-31,CA,Santa Cruz,1,0,1,20
2018-11-30,WA,Clark,1188,830,2018,310997
2018-08-31,WA,Lewis,83,62,145,57867
2017-07-31,WA,Thurston,0,0,0,53297
2018-10-31,WA,Grant,0,0,0,26085
2021-04-30,WA,Whitman,0,0,0,8564
2020-07-31,WA,Wahkiakum,6,6,12,3001
2022-06-30,CA,Kings,2,1,3,298
2022-03-31,WA,Kitsap,2274,1006,3280,179292
2019-09-30,WA,Garfield,0,1,1,1311
2021-07-31,WA,Whitman,61,49,110,21944
2020-01-31,CA,Fresno,1,0,1,190
2020-06-30,WA,Snohomish,0,0,0,123942
2022-08-31,WA,Lincoln,9,16,25,7697
2017-12-31,WA,Mason,66,75,141,44844
2022-02-28,WA,Cowlitz,0,1,1,28908
2022-06-30,WA,Cowlitz,2,1,3,28556
2020-01-31,WA,Cowlitz,127,111,238,73602
2022-08-31,CA,San Diego,18,10,28,2167
2023-01-31,WA,Columbia,8,1,9,2438
2022-05-31,WA,Island,797,373,1170,62040
2020-12-31,WA,Walla Walla,98,67,165,36134
2020-08-31,CA,Sacramento,1,0,1,255
2020-05-31,WA,Benton,0,0,0,42474
2022-06-30,WA,Cowlitz,336,172,508,70742
2021-05-31,WA,Whitman,60,44,104,22016
2019-04-30,WA,Clallam,0,0,0,21681
2020-12-31,WA,Pend Oreille,0,0,0,5715
2019-08-31,WA,King,6,1,7,182265
2018-12-31,WA,Stevens,0,0,0,18764
2017-11-30,WA,Walla Walla,0,0,0,13312
2017-06-30,WA,Lewis,51,34,85,55546
2022-08-31,CA,Monterey,1,1,2,125
2020-08-31,WA,Snohomish,4645,1782,6427,536082
2022-01-31,WA,Douglas,0,0,0,12682
2019-02-28,WA,Stevens,0,0,0,18757
2021-07-31,WA,Klickitat,77,50,127,15342
2017-08-31,CA,Marin,1,0,1,58
2017-04-30,WA,Chelan,55,31,86,51695
2021-01-31,WA,Douglas,84,46,130,28199
2019-07-31,WA,Pacific,24,30,54,16029
2022-04-30,CA,Kern,0,1,1,191
2017-03-31,WA,Pend Oreille,1,4,5,9307
2017-01-31,WA,Lewis,43,30,73,54960
2017-08-31,WA,Island,124,149,273,60582
2020-12-31,WA,Benton,440,355,795,134989
2020-12-31,WA,Skamania,0,0,0,4004
2018-10-31,WA,Pacific,0,0,0,7630
2017-10-31,WA,Skagit,151,126,277,88959
2018-05-31,WA,Chelan,103,49,152,53497
2017-12-31,WA,Grays Harbor,42,41,83,45821
2017-04-30,WA,Mason,49,64,113,43002
2017-03-31,CA,Tulare,1,0,1,194
2017-03-31,WA,Whitman,0,0,0,8389
2018-06-30,WA,Walla Walla,34,43,77,35660
2021-11-30,WA,Grays Harbor,191,155,346,49503
2023-04-30,WA,Whitman,138,73,211,21935
2017-11-30,WA,Garfield,0,0,0,937
2017-07-31,WA,Douglas,0,0,0,11515
2020-01-31,WA,Clark,0,0,0,81767
2018-04-30,WA,Island,184,177,361,62281
2018-06-30,WA,Douglas,43,31,74,27649
2018-11-30,WA,Ferry,0,0,0,3582
2019-07-31,WA,Garfield,0,0,0,961
2020-10-31,WA,Garfield,0,0,0,991
2017-06-30,WA,Stevens,0,0,0,18273
2017-08-31,WA,Mason,0,0,0,19333
2021-06-30,WA,Douglas,0,0,0,12685
2018-09-30,WA,Yakima,0,0,0,58690
2020-04-30,CA,Kern,0,1,1,225
2018-04-30,WA,Pierce,0,0,0,137364
2018-04-30,WA,Jefferson,0,0,0,9525
2023-06-30,WA,Chelan,637,162,799,53633
2022-10-31,WA,Cowlitz,381,184,565,70323
2023-01-31,CA,Alameda,3,0,3,154
2020-11-30,WA,Grays Harbor,0,0,0,21133
2019-12-31,WA,Whatcom,987,477,1464,151703
2022-06-30,CA,Marin,0,1,1,29
2023-04-30,WA,Spokane,2159,1032,3191,321308
2021-11-30,CA,San Bernardino,0,1,1,363
2020-11-30,WA,Columbia,4,3,7,2439
2020-05-31,CA,San Joaquin,1,0,1,127
2018-01-31,WA,Chelan,94,38,132,53236
2020-09-30,CA,Orange,5,3,8,464
2022-12-31,WA,Pacific,2,0,2,7838
2017-06-30,WA,Columbia,0,0,0,1531
2022-08-31,WA,Whatcom,1915,766,2681,148907
2021-07-31,WA,Cowlitz,229,146,375,72247
2022-05-31,WA,Clallam,1,0,1,21957
2023-07-31,WA,Lincoln,0,0,0,4756
2022-05-31,WA,Mason,304,179,483,47338
2019-11-30,WA,Columbia,0,0,0,1535
2017-03-31,CA,Alameda,3,1,4,383
2021-09-30,CA,Placer,2,0,2,70
2022-06-30,WA,Whatcom,1814,737,2551,149016
2021-09-30,CA,Santa Clara,8,2,10,241
2023-02-28,WA,Asotin,0,0,0,6661
2020-04-30,WA,Kittitas,0,0,0,14593
2022-03-31,WA,Lewis,0,0,0,26519
2023-04-30,WA,Kitsap,3049,1231,4280,175820
2020-08-31,WA,Clallam,1,0,1,21704
2019-12-31,CA,Kern,0,1,1,222
2023-06-30,CA,Sacramento,5,0,5,126
2017-06-30,WA,King,8,1,9,187744
2021-01-31,WA,Kitsap,0,0,0,54300
2023-04-30,WA,Yakima,11,0,11,60803
2021-09-30,WA,Whatcom,1540,641,2181,150546
2019-07-31,WA,Lincoln,2,10,12,7793
2022-10-31,WA,Stevens,2,0,2,18903
2021-01-31,WA,Kittitas,134,52,186,29834
2017-02-28,CA,Riverside,1,1,2,842
2021-09-30,CA,Kern,0,1,1,197
2020-12-31,WA,Chelan,0,0,0,22804
2018-09-30,WA,Franklin,37,65,102,58512
2022-06-30,WA,Grays Harbor,210,160,370,49043
2022-02-28,CA,Riverside,5,1,6,476
2022-05-31,WA,Stevens,0,0,0,18961
2020-07-31,WA,Benton,373,321,694,134304
2019-08-31,WA,Thurston,0,0,0,55440
2020-09-30,WA,Grays Harbor,115,116,231,48482
2021-07-31,WA,Walla Walla,0,0,0,14055
2019-04-30,WA,Kitsap,1,0,1,53874
2023-03-31,WA,Asotin,0,0,0,6642
2018-12-31,WA,Clark,0,0,0,79840
2018-12-31,CA,Orange,6,2,8,539
2021-04-30,WA,Clark,2681,1330,4011,321630
2017-08-31,WA,Mason,59,73,132,43923
2019-02-28,CA,Orange,5,2,7,533
2019-11-30,WA,Snohomish,3943,1706,5649,535420
2018-03-31,WA,Skagit,173,154,327,89895
2018-08-31,CA,Monterey,0,1,1,186
2020-01-31,WA,Cowlitz,0,0,0,29028
2019-12-31,WA,Whitman,42,46,88,22678
2022-05-31,WA,Cowlitz,322,175,497,70710
2018-05-31,CA,Tuolumne,0,1,1,12
2018-05-31,WA,Whatcom,2,0,2,42191
2020-02-29,WA,Whatcom,1042,486,1528,151612
2023-06-30,WA,Thurston,3092,1222,4314,188101
2018-01-31,WA,Douglas,43,33,76,27223
2019-07-31,WA,Okanogan,23,26,49,26123
2021-07-31,CA,Santa Clara,8,2,10,247
2019-08-31,WA,Skamania,0,0,0,4075
2022-01-31,WA,Grant,140,100,240,66811
2018-03-31,WA,Clark,918,641,1559,306002
2021-02-28,WA,Garfield,0,0,0,1006
2019-09-30,WA,Pierce,0,0,0,140471
2018-09-30,CA,Riverside,2,2,4,688
2021-08-31,WA,Franklin,139,99,238,61954
2021-12-31,WA,King,6,1,7,183027
2018-12-31,WA,Okanogan,0,0,0,16487
2017-02-28,WA,Garfield,0,0,0,1290
2018-10-31,WA,Wahkiakum,0,0,0,1701
2019-11-30,WA,Okanogan,0,0,0,16557
2018-04-30,WA,Kittitas,0,0,0,13993
2019-08-31,CA,San Francisco,2,1,3,106
2023-07-31,WA,Grays Harbor,9,0,9,20411
2022-11-30,WA,Pacific,1,0,1,7853
2017-09-30,WA,Thurston,0,0,0,53500
2022-10-31,WA,Adams,22,12,34,13045
2018-08-31,WA,Clallam,0,0,0,21476
2023-04-30,WA,Klickitat,139,59,198,15114
2020-03-31,CA,Kern,0,1,1,220
2022-02-28,CA,Orange,4,2,6,369
2018-03-31,WA,Franklin,0,0,0,18617
2022-03-31,WA,Wahkiakum,0,0,0,1814
2021-08-31,WA,Adams,0,0,0,5413
2023-03-31,CA,Santa Barbara,1,0,1,62
2023-01-31,WA,Ferry,24,4,28,4346
2017-01-31,WA,Okanogan,0,0,0,16374
2022-12-31,CA,Monterey,1,1,2,117
2021-04-30,WA,Okanogan,60,36,96,26414
2017-08-31,WA,Columbia,1,1,2,2352
2017-09-30,WA,Garfield,0,0,0,940
2019-08-31,WA,Ferry,5,2,7,4414
2019-11-30,WA,Adams,0,0,0,5184
2020-02-29,WA,Kitsap,1273,661,1934,182316
2023-03-31,WA,Whatcom,2264,837,3101,147416
2017-11-30,WA,Mason,0,0,0,19540
2022-09-30,CA,Los Angeles,7,6,13,695
2018-06-30,WA,Island,0,0,0,20955
2022-03-31,WA,Skamania,65,45,110,8278
2019-03-31,WA,Garfield,0,0,0,954
2021-06-30,WA,Stevens,0,0,0,18947
2022-11-30,CA,Placer,2,0,2,59
2020-07-31,WA,Ferry,0,0,0,3568
2017-12-31,WA,Lincoln,0,0,0,4493
2019-07-31,WA,Pierce,1877,1570,3447,544359
2019-10-31,CA,Kern,0,1,1,222
2021-07-31,WA,Island,0,0,0,21573
2020-09-30,WA,Whitman,47,47,94,21996
2022-12-31,WA,Clallam,482,262,744,49422
2020-01-31,WA,Mason,0,0,0,20563
2023-01-31,WA,Lewis,2,0,2,26285
2021-06-30,WA,Kitsap,1851,859,2710,180524
2017-07-31,CA,Riverside,1,1,2,787
2019-02-28,WA,Douglas,52,35,87,27939
2018-06-30,WA,Skamania,11,9,20,8660
2018-09-30,WA,Mason,0,0,0,20090
2019-05-31,WA,San Juan,0,0,0,5850
2023-04-30,WA,Island,28,0,28,21017
2022-03-31,WA,Stevens,60,50,110,30089
2020-11-30,WA,Franklin,78,80,158,61166
2023-04-30,WA,Garfield,0,0,0,976
2018-03-31,WA,Skagit,1,0,1,31922
2017-12-31,WA,Chelan,86,38,124,53028
2021-07-31,CA,Monterey,0,1,1,143
2018-10-31,WA,Lincoln,0,0,0,4608
2021-03-31,CA,Solano,1,0,1,195
2017-05-31,WA,King,8,1,9,188266
2020-12-31,WA,Pend Oreille,12,4,16,9171
2017-06-30,WA,Pierce,956,842,1798,524957
2023-05-31,WA,Kitsap,3126,1246,4372,175192
2017-01-31,CA,Riverside,1,1,2,888
2022-02-28,WA,Clark,2,0,2,83758
2018-05-31,WA,Walla Walla,0,0,0,13389
2019-05-31,WA,Mason,0,0,0,20364
2019-08-31,WA,Jefferson,0,0,0,9675
2022-04-30,CA,Los Angeles,8,7,15,777
2019-03-31,WA,Whitman,27,41,68,22715
2019-05-31,CA,Fresno,1,0,1,188
2023-04-30,CA,Santa Cruz,1,0,1,13
2019-07-31,WA,Clallam,177,144,321,50640
2023-06-30,WA,Klickitat,12,0,12,8137
2023-05-31,WA,Wahkiakum,2,0,2,1753
2018-01-31,CA,Orange,3,1,4,565
2022-10-31,CA,San Joaquin,1,0,1,76
2020-02-29,WA,Franklin,58,76,134,61129
2018-05-31,WA,San Juan,141,56,197,14046
2020-01-31,WA,Grant,0,0,0,27036
2017-02-28,WA,Kittitas,15,15,30,27062
2021-02-28,WA,Pierce,3029,1810,4839,555482
2018-07-31,WA,Garfield,0,0,0,956
2020-11-30,WA,Kitsap,0,0,0,54292
2017-12-31,WA,Clallam,0,0,0,21218
2020-05-31,WA,Pend Oreille,0,0,0,5741
2021-08-31,WA,Asotin,0,0,0,6755
2023-07-31,WA,Kitsap,80,0,80,51022
2022-06-30,WA,Klickitat,103,55,158,15251
2022-09-30,WA,Clallam,6,0,6,21889
2021-12-31,WA,Franklin,0,0,0,20851
2019-10-31,WA,Grays Harbor,95,95,190,48305
2018-04-30,WA,Skagit,1,0,1,31980
2023-06-30,WA,Grant,11,0,11,27666
2017-01-31,CA,Tulare,1,0,1,203
2020-03-31,WA,Okanogan,0,0,0,16458
2022-04-30,WA,Grays Harbor,0,0,0,21346
2023-01-31,WA,Pacific,2,0,2,7831
2017-07-31,WA,Skamania,0,0,0,3873
2023-04-30,WA,Adams,24,12,36,12970
2019-08-31,WA,Pierce,1930,1584,3514,544791
2020-04-30,WA,Lewis,0,0,0,25979
2023-02-28,WA,Cowlitz,7,0,7,28319
2017-07-31,WA,Mason,57,71,128,43631
2022-10-31,CA,Sacramento,3,0,3,177
2019-04-30,WA,Lewis,95,91,186,58821
2017-10-31,WA,Pierce,0,0,0,137020
2021-10-31,CA,Orange,5,2,7,389
2023-07-31,WA,Adams,24,12,36,12621
2021-02-28,WA,Benton,460,362,822,135084
2019-05-31,WA,Kittitas,0,0,0,14377
2019-08-31,CA,Los Angeles,8,6,14,1104
2021-12-31,CA,San Mateo,2,0,2,78
2022-03-31,WA,Thurston,2028,1000,3028,195451
2020-09-30,WA,Klickitat,0,0,0,8105
2023-01-31,WA,Pend Oreille,23,14,37,8954
2017-06-30,WA,Pacific,10,7,17,15145
2019-04-30,WA,Kittitas,0,0,0,14296
2019-05-31,CA,Kern,0,1,1,224
2019-11-30,WA,Clallam,1,0,1,21847
2018-11-30,WA,Cowlitz,69,91,160,72372
2023-02-28,CA,Sacramento,4,0,4,152
2017-09-30,WA,Pierce,0,0,0,137078
2022-04-30,WA,Island,1,0,1,21467
2020-10-31,WA,Grays Harbor,118,117,235,48521
2022-01-31,WA,Mason,272,161,433,47766
2018-11-30,CA,Los Angeles,7,5,12,1126
2022-11-30,WA,Mason,7,0,7,20895
2019-11-30,WA,Pierce,0,0,0,140707
2021-03-31,WA,Lincoln,0,0,0,4733
2021-07-31,WA,Garfield,0,0,0,1004
2021-02-28,WA,Franklin,92,87,179,61606
2021-08-31,WA,Kitsap,0,0,0,54394
2018-08-31,CA,Contra Costa,0,1,1,440
2019-07-31,CA,Ventura,0,2,2,311
2021-03-31,WA,Columbia,0,0,0,1549
2023-03-31,WA,Lincoln,18,16,34,7696
2019-08-31,WA,Lewis,105,96,201,59363
2023-07-31,WA,Walla Walla,223,113,336,34442
2017-07-31,WA,Whitman,0,0,0,8425
2018-08-31,WA,Island,0,0,0,21052
2020-10-31,CA,San Mateo,1,1,2,105
2020-11-30,WA,Grant,0,0,0,27418
2017-11-30,WA,Douglas,0,0,0,11702
2022-08-31,WA,Walla Walla,2,0,2,13914
2021-05-31,WA,Pacific,0,0,0,7939
2021-10-31,WA,King,4,1,5,183489
2020-01-31,WA,Kitsap,1,0,1,54484
2019-12-31,WA,Pend Oreille,7,7,14,9514
2019-05-31,WA,Kitsap,1036,588,1624,180694
2023-05-31,CA,San Diego,16,9,25,1823
2021-06-30,CA,San Diego,16,6,22,2559
2020-05-31,CA,Santa Clara,7,2,9,304
2019-01-31,WA,Lincoln,0,0,0,4666
2022-08-31,WA,Clark,4348,1852,6200,315595
2019-08-31,WA,Mason,0,0,0,20413
2017-04-30,WA,Columbia,0,1,1,2358
2023-03-31,WA,Spokane,30,0,30,101755
2018-09-30,WA,San Juan,0,0,0,5761
2022-05-31,WA,King,40013,11054,51067,1349163
2021-01-31,WA,Ferry,9,3,12,4341
2022-07-31,WA,Grant,0,0,0,27963
2018-09-30,WA,Asotin,0,0,0,6631
2022-10-31,CA,Ventura,2,1,3,213
2018-11-30,WA,Kittitas,0,0,0,14162
2020-09-30,WA,Jefferson,257,148,405,24734
2023-01-31,WA,Stevens,2,0,2,18772
2021-10-31,WA,Stevens,52,43,95,30243
2017-07-31,WA,Lewis,52,36,88,55557
2023-01-31,CA,Solano,4,0,4,140
2018-05-31,WA,Douglas,44,31,75,27541
2018-10-31,WA,Klickitat,24,32,56,15389
2023-03-31,WA,Pierce,126,0,126,137873
2019-05-31,CA,Solano,1,0,1,215
2017-10-31,WA,Asotin,0,0,0,6524
2019-02-28,WA,Lewis,96,84,180,58309
2018-06-30,WA,Jefferson,144,97,241,24453
2019-09-30,WA,Whatcom,2,0,2,43030
2019-09-30,WA,Mason,0,0,0,20438
2020-03-31,CA,Ventura,0,3,3,293
2018-02-28,WA,King,11758,5019,16777,1368249
2020-03-31,WA,Clallam,214,166,380,50661
2018-06-30,WA,Grant,0,0,0,25921
2018-04-30,WA,Okanogan,8,19,27,25823
2021-01-31,WA,Wahkiakum,7,6,13,3040
2020-05-31,WA,Lincoln,4,12,16,7640
2019-02-28,WA,Okanogan,19,21,40,25964
2019-01-31,WA,Pacific,22,26,48,15882
2018-03-31,WA,Benton,176,187,363,130785
2019-02-28,WA,Spokane,481,386,867,307236
2022-03-31,WA,Whitman,0,0,0,8588
2021-11-30,WA,Pierce,0,0,0,145138
2018-07-31,WA,Yakima,0,0,0,58542
2019-05-31,WA,Jefferson,191,119,310,25001
2023-01-31,WA,Whatcom,2153,822,2975,148714
2018-11-30,WA,Mason,103,110,213,46427
2017-04-30,WA,Asotin,0,0,0,6504
2021-08-31,CA,Ventura,1,2,3,251
2022-02-28,WA,King,22,1,23,182492
2021-12-31,WA,Thurston,1867,964,2831,196824
2022-06-30,CA,Santa Cruz,1,0,1,22
2018-12-31,WA,King,16280,6530,22810,1378186
2020-09-30,WA,Clark,0,0,0,82868
2021-03-31,WA,Benton,0,0,0,43534
2022-04-30,WA,Asotin,24,19,43,12707
2020-09-30,CA,Los Angeles,9,11,20,976
2020-09-30,WA,Kitsap,0,0,0,54186
2022-10-31,WA,Snohomish,76,0,76,122941
2017-06-30,WA,Chelan,0,0,0,21303
2022-03-31,WA,Chelan,0,0,0,23048
2019-04-30,WA,Garfield,1,1,2,1298
2020-05-31,WA,Wahkiakum,0,0,0,1759
2018-10-31,WA,Spokane,1,0,1,93433
2019-01-31,WA,San Juan,190,68,258,14255
2022-08-31,CA,Ventura,2,1,3,221
2017-04-30,WA,Whatcom,441,159,600,142459
2018-01-31,WA,Clallam,0,0,0,21280
2022-08-31,WA,Chelan,487,134,621,54190
2019-07-31,WA,Douglas,60,37,97,28078
2017-03-31,WA,Columbia,0,1,1,2355
2022-02-28,CA,Sacramento,2,0,2,202
2021-10-31,WA,Skagit,649,295,944,91478
2017-07-31,WA,Whatcom,474,179,653,143186
2022-06-30,WA,Lewis,235,177,412,59751
2020-01-31,WA,Douglas,0,0,0,12312
2023-03-31,CA,Monterey,1,1,2,110
2017-02-28,WA,Skagit,113,86,199,87262
2018-02-28,WA,Skamania,0,0,0,3920
2017-06-30,WA,Jefferson,0,0,0,9424
2022-04-30,CA,Riverside,7,1,8,471
2022-11-30,CA,Ventura,2,1,3,212
2020-07-31,CA,Solano,1,0,1,207
2019-07-31,WA,Douglas,0,0,0,12221
2020-02-29,WA,Asotin,16,11,27,12671
2020-07-31,WA,Klickitat,56,43,99,15115
2020-05-31,CA,Alameda,2,1,3,271
2021-10-31,WA,Spokane,1218,727,1945,326533
2021-01-31,CA,San Joaquin,1,0,1,107
2021-12-31,CA,Kings,2,1,3,321
2019-10-31,WA,Spokane,1,0,1,96090
2020-03-31,WA,Clark,1983,1061,3044,320288
2020-09-30,WA,Yakima,0,0,0,60573
2023-02-28,CA,Contra Costa,0,3,3,199
2017-05-31,WA,Asotin,0,0,0,6491
2018-02-28,WA,Asotin,0,0,0,6580
2018-05-31,CA,Los Angeles,7,4,11,1157
2017-06-30,WA,Pend Oreille,0,0,0,5574
2022-04-30,WA,Douglas,0,0,0,12748
2018-02-28,WA,Skamania,11,8,19,8624
2018-03-31,WA,Benton,0,0,0,40794
2020-09-30,WA,Pend Oreille,8,4,12,9189
2018-05-31,WA,Columbia,0,0,0,1526
2018-11-30,WA,Lewis,0,0,0,25625
2020-04-30,WA,Yakima,0,0,0,59516
2022-07-31,CA,Riverside,7,1,8,439
2021-11-30,WA,Kittitas,196,75,271,29843
2017-10-31,WA,Wahkiakum,0,2,2,2849
2018-10-31,WA,Kitsap,1,0,1,53622
2020-10-31,CA,Alameda,2,0,2,255
2022-02-28,WA,Skamania,59,45,104,8311
2022-06-30,WA,Clark,7,0,7,82837
2022-06-30,WA,Ferry,0,0,0,3577
2018-07-31,WA,Ferry,3,3,6,4424
2017-05-31,WA,Jefferson,0,0,0,9440
2018-07-31,WA,Clallam,127,111,238,49977
2021-10-31,WA,Kittitas,0,0,0,14773
2020-12-31,WA,Wahkiakum,0,0,0,1770
2019-05-31,WA,Klickitat,35,33,68,15550
2023-02-28,WA,Grant,241,114,355,66906
2021-08-31,WA,Douglas,103,51,154,28575
2020-12-31,CA,Monterey,0,1,1,156
2022-07-31,WA,Yakima,1,0,1,61344
2023-01-31,WA,Walla Walla,3,0,3,13863
2019-06-30,WA,Benton,0,0,0,41914
2022-10-31,WA,King,300,2,302,179312
2020-03-31,WA,Yakima,124,116,240,165838
2023-03-31,WA,Kitsap,2952,1199,4151,176394
2020-11-30,CA,Monterey,0,1,1,155
2018-03-31,WA,Island,175,178,353,62057
2018-04-30,WA,Lincoln,2,6,8,7613
2021-08-31,WA,Grays Harbor,0,0,0,21395
2021-12-31,CA,San Diego,15,8,23,2410
2019-08-31,WA,Douglas,0,0,0,12264
2023-05-31,WA,Skamania,101,58,159,7977
2017-09-30,WA,Spokane,276,229,505,298150
2018-08-31,WA,Stevens,12,26,38,31687
2020-01-31,CA,Kern,0,1,1,225
2021-03-31,WA,Stevens,38,43,81,30317
2018-03-31,WA,Wahkiakum,1,2,3,2871
2018-09-30,WA,San Juan,161,68,229,14183
2021-11-30,WA,Pacific,51,64,115,16071
2019-01-31,WA,Lewis,95,82,177,58367
2018-11-30,WA,Grant,0,0,0,26159
2017-04-30,WA,Garfield,0,0,0,1283
2023-04-30,WA,Pend Oreille,0,0,0,5600
2017-03-31,WA,Island,105,129,234,59602
2017-03-31,CA,Riverside,1,1,2,828
2020-06-30,WA,Columbia,0,0,0,1532
2018-09-30,WA,Chelan,0,0,0,22027
2022-01-31,WA,Pacific,0,0,0,8024
2017-01-31,CA,Contra Costa,1,0,1,683
2023-04-30,WA,Asotin,0,0,0,6607
2019-09-30,WA,Adams,0,0,0,5139
2021-10-31,WA,Chelan,385,110,495,54679
2022-05-31,WA,Yakima,0,0,0,61425
2023-03-31,WA,Jefferson,9,0,9,9314
2023-07-31,WA,Stevens,117,69,186,28933
2018-07-31,WA,Kittitas,0,0,0,14053
2021-09-30,WA,Stevens,51,42,93,30327
2019-01-31,WA,King,17167,6678,23845,1381057
2022-09-30,WA,Kittitas,4,0,4,14604
2017-12-31,WA,Franklin,30,50,80,56860
2019-02-28,WA,Adams,0,0,0,5109
2021-05-31,WA,Clark,2757,1368,4125,321959
2020-11-30,WA,Thurston,0,0,0,56280
2021-11-30,WA,Clallam,1,0,1,22115
2021-11-30,WA,Mason,0,0,0,21254
2018-09-30,WA,Skagit,1,0,1,32261
2017-03-31,WA,Lincoln,2,4,6,7506
2022-12-31,WA,Pierce,6159,2513,8672,539032
2018-06-30,WA,Spokane,1,0,1,92636
2021-11-30,WA,Grant,0,0,0,28045
2018-02-28,WA,Kittitas,0,0,0,13948
2018-06-30,WA,Clallam,124,112,236,49911
2017-06-30,WA,Island,117,136,253,60111
2019-08-31,WA,Jefferson,205,122,327,25074
2018-10-31,WA,Stevens,14,28,42,31809
2018-02-28,WA,Grays Harbor,42,44,86,45889
2022-06-30,WA,Franklin,186,109,295,62000
2022-11-30,WA,Garfield,1,3,4,1307
2017-01-31,WA,Jefferson,87,53,140,23606
2023-04-30,WA,Skamania,1,0,1,3828
2023-06-30,WA,Whitman,150,79,229,21790
2023-01-31,CA,Orange,7,2,9,289
2023-04-30,CA,Riverside,6,1,7,357
2022-07-31,WA,Kitsap,2463,1074,3537,178200
2019-01-31,WA,Yakima,0,0,0,58929
2019-03-31,WA,Pierce,0,0,0,139004
2018-11-30,WA,Cowlitz,0,0,0,28723
2020-10-31,WA,Grays Harbor,0,0,0,21123
2021-02-28,WA,Lincoln,0,0,0,4689
2021-07-31,CA,Ventura,1,2,3,250
2017-03-31,CA,Santa Clara,6,2,8,415
2021-12-31,WA,Spokane,1310,758,2068,327386
2019-05-31,WA,King,18616,6948,25564,1387314
2023-05-31,CA,Orange,6,2,8,260
2023-05-31,WA,Lewis,309,203,512,58552
2022-02-28,WA,Klickitat,92,53,145,15306
2022-06-30,CA,Alameda,4,0,4,180
2017-05-31,WA,Whatcom,455,167,622,142686
2018-12-31,WA,Okanogan,16,22,38,26070
2023-02-28,WA,Mason,394,199,593,46628
2023-07-31,CA,Riverside,6,0,6,325
2022-01-31,CA,Kings,2,1,3,317
2017-11-30,WA,Clark,0,0,0,78247
2022-06-30,WA,Columbia,0,0,0,1579
2018-06-30,WA,Snohomish,2349,1262,3611,521519
2022-10-31,WA,Klickitat,114,51,165,15116
2022-02-28,WA,Pend Oreille,17,9,26,9075
2017-02-28,WA,Jefferson,0,0,0,9472
2022-04-30,WA,Pend Oreille,0,0,0,5657
2019-10-31,WA,Skagit,1,0,1,32558
2022-11-30,WA,Thurston,34,0,34,54782
2017-05-31,WA,Ferry,1,1,2,4409
2021-02-28,WA,Clark,2505,1245,3750,318957
2023-03-31,WA,Pend Oreille,0,0,0,5572
2020-04-30,CA,Contra Costa,3,2,5,322
2019-09-30,WA,Douglas,0,0,0,12275
2018-12-31,CA,Contra Costa,0,2,2,408
2021-06-30,WA,Lincoln,5,13,18,7738
2017-03-31,WA,Cowlitz,51,48,99,69297
2023-04-30,WA,Benton,1089,545,1634,135049
2021-03-31,WA,Pend Oreille,12,6,18,9281
2017-01-31,WA,Grays Harbor,0,0,0,19862
2020-01-31,WA,Snohomish,4244,1718,5962,537912
2021-07-31,WA,Spokane,0,0,0,102316
2018-08-31,WA,San Juan,152,66,218,14152
2017-11-30,CA,Santa Clara,7,1,8,385
2021-01-31,CA,Santa Cruz,1,0,1,27
2020-04-30,WA,Clark,0,0,0,81837
2018-12-31,WA,Pend Oreille,5,5,10,9533
2023-05-31,WA,Yakima,484,249,733,164633
2021-09-30,WA,Island,661,329,990,63226
2023-07-31,WA,Pierce,166,0,166,132850
2017-09-30,WA,Cowlitz,0,0,0,28041
2020-07-31,WA,Adams,0,0,0,5283
2022-02-28,CA,Marin,0,1,1,30
2017-06-30,WA,Thurston,0,0,0,53295
2019-03-31,WA,Adams,4,6,10,12632
2017-05-31,CA,Ventura,0,1,1,360
2023-02-28,WA,Whatcom,2212,826,3038,148577
2017-01-31,CA,Ventura,0,2,2,392
2022-06-30,WA,Pierce,6,0,6,141892
2020-07-31,CA,Kern,0,1,1,223
2023-04-30,CA,Napa,0,1,1,10
2021-09-30,WA,Pacific,49,57,106,16073
2020-02-29,CA,San Francisco,2,1,3,100
2022-08-31,WA,Skagit,5,0,5,32237
2017-02-28,WA,Pierce,862,778,1640,526771
2017-08-31,WA,Island,0,0,0,20519
2020-04-30,WA,Snohomish,4400,1751,6151,535202
2019-12-31,CA,Tuolumne,0,1,1,11
2023-06-30,CA,Marin,0,1,1,26
2018-04-30,WA,Okanogan,0,0,0,16350
2018-04-30,CA,Alameda,0,1,1,352
2021-03-31,CA,Kern,0,1,1,213
2020-06-30,WA,Snohomish,4434,1765,6199,534548
2019-08-31,WA,Benton,0,0,0,42177
2018-10-31,WA,Pierce,1405,1305,2710,537166
2021-08-31,WA,Jefferson,350,183,533,24858
2018-12-31,WA,Columbia,2,2,4,2421
2020-10-31,WA,Columbia,4,3,7,2439
2022-07-31,WA,King,123,2,125,180390
2021-03-31,CA,Ventura,1,1,2,265
2017-05-31,WA,Spokane,245,211,456,296382
2021-04-30,CA,Santa Cruz,1,0,1,26
2020-08-31,WA,Cowlitz,0,0,0,28911
2020-12-31,WA,Franklin,0,0,0,20434
2019-06-30,WA,Whitman,0,0,0,8584
2023-01-31,WA,Benton,961,512,1473,135906
2018-09-30,CA,Fresno,1,0,1,191
2018-07-31,WA,Adams,0,0,0,5161
2019-12-31,WA,Kitsap,1,0,1,54446
2022-03-31,WA,King,25,1,26,182051
2023-01-31,WA,Pierce,97,0,97,139157
2023-04-30,WA,Thurston,2918,1188,4106,190129
2022-06-30,WA,Yakima,336,190,526,167038
2018-07-31,WA,Kittitas,48,32,80,28990
2019-06-30,WA,Cowlitz,98,108,206,73013
2018-09-30,WA,Garfield,0,0,0,966
2017-08-31,WA,Clallam,0,0,0,21059
2018-01-31,WA,Pacific,0,0,0,7534
2020-01-31,WA,Okanogan,0,0,0,16557
2023-02-28,WA,Pend Oreille,26,13,39,8936
2018-12-31,CA,Alameda,0,2,2,323
2017-06-30,WA,Spokane,1,0,1,90624
2020-05-31,WA,Walla Walla,70,62,132,35820
2017-02-28,CA,Ventura,0,2,2,376
2022-06-30,CA,Fresno,1,0,1,134
2020-02-29,WA,Chelan,216,78,294,54606
2017-02-28,WA,Grays Harbor,0,0,0,19819
2021-01-31,CA,Solano,1,0,1,198
2019-12-31,WA,Stevens,0,0,0,18761
2019-03-31,WA,Grant,0,0,0,26337
2021-07-31,WA,Skagit,1,0,1,33023
2021-04-30,WA,Clark,0,0,0,84198
2021-02-28,WA,Benton,0,0,0,43381
2022-08-31,WA,Skamania,82,50,132,8155
2022-05-31,WA,Walla Walla,171,97,268,35973
2020-06-30,WA,Douglas,0,0,0,12308
2022-09-30,WA,Skamania,0,0,0,3908
2020-09-30,WA,Franklin,0,0,0,20289
2017-05-31,WA,Clallam,84,74,158,48203
2020-05-31,WA,Asotin,16,12,28,12338
2018-02-28,WA,Clallam,0,0,0,21289
2017-11-30,CA,Tuolumne,0,1,1,16
2019-03-31,WA,Pend Oreille,5,5,10,9474
2019-09-30,WA,Clark,0,0,0,80968
2018-05-31,WA,Yakima,0,0,0,58338
2019-02-28,WA,Columbia,2,2,4,2430
2021-04-30,WA,Grant,0,0,0,27879
2017-03-31,WA,Jefferson,94,57,151,23648
2020-05-31,WA,Benton,354,321,675,134165
2020-01-31,WA,San Juan,265,83,348,14402
2023-04-30,WA,Kitsap,64,0,64,52364
2021-10-31,CA,Santa Cruz,1,0,1,25
2018-05-31,WA,Asotin,0,0,0,6631
2017-10-31,CA,Marin,1,0,1,58
2021-04-30,WA,Spokane,1000,611,1611,324879
2017-08-31,WA,Yakima,0,0,0,57643
2020-02-29,WA,Snohomish,4302,1729,6031,538151
2019-01-31,WA,Grays Harbor,67,76,143,47449
2020-12-31,WA,Adams,10,7,17,12960
2021-12-31,WA,Pierce,0,0,0,144818
2018-11-30,WA,Jefferson,0,0,0,9615
2021-10-31,WA,Lincoln,0,0,0,4804
2022-09-30,CA,Placer,2,0,2,61
2023-02-28,CA,Napa,0,1,1,9
2019-05-31,CA,San Joaquin,1,0,1,131
2023-04-30,WA,Lewis,302,195,497,58597
2022-10-31,WA,Skamania,85,51,136,8110
2020-02-29,WA,Jefferson,0,0,0,9642
2021-10-31,CA,San Diego,16,8,24,2467
2021-04-30,WA,Kitsap,0,0,0,54575
2022-08-31,WA,Grant,1,0,1,27998
2020-04-30,WA,Grays Harbor,106,110,216,48072
2020-12-31,WA,King,6,1,7,184370
2021-02-28,WA,Jefferson,295,168,463,24790
2017-01-31,WA,San Juan,84,31,115,13348
2017-08-31,WA,Skagit,1,0,1,31515
2020-05-31,WA,Skagit,400,216,616,91169
2019-08-31,CA,Orange,6,3,9,523
2023-06-30,WA,King,56981,14563,71544,1312113
2023-02-28,WA,Kittitas,322,92,414,29510
2022-10-31,WA,Klickitat,3,0,3,8250
2017-06-30,WA,Thurston,398,336,734,186654
2020-08-31,WA,Douglas,77,41,118,28010
2020-03-31,WA,Grays Harbor,0,0,0,20787
2022-03-31,CA,Monterey,1,1,2,129
2018-09-30,WA,Franklin,0,0,0,18876
2019-03-31,WA,Lewis,95,90,185,58524
2017-05-31,WA,Island,0,0,0,20531
2017-10-31,WA,Island,0,0,0,20596
2018-10-31,WA,Franklin,0,0,0,18952
2023-07-31,CA,Los Angeles,4,4,8,509
2023-05-31,CA,Contra Costa,0,3,3,183
2018-08-31,WA,King,7,1,8,182994
2018-10-31,WA,Kittitas,0,0,0,14126
2021-07-31,WA,Kittitas,0,0,0,14792
2018-12-31,CA,San Diego,8,2,10,2569
2021-11-30,WA,Chelan,0,0,0,23094
2019-08-31,WA,Klickitat,0,0,0,8292
2017-01-31,WA,Franklin,0,0,0,17912
2019-04-30,WA,Skagit,1,0,1,32325
2022-01-31,WA,Skamania,0,0,0,3990
2017-07-31,CA,Orange,3,1,4,627
2023-07-31,CA,Santa Barbara,1,0,1,57
2021-03-31,WA,Whitman,54,44,98,21932
2017-10-31,WA,Klickitat,22,27,49,14805
2022-07-31,WA,Jefferson,3,0,3,9457
2023-01-31,CA,Kern,1,1,2,186
2023-02-28,WA,Skamania,1,0,1,3860
2019-02-28,WA,Whatcom,2,0,2,42708
2023-04-30,WA,Franklin,4,0,4,20798
2022-08-31,WA,Yakima,364,204,568,166544
2020-12-31,CA,Alameda,3,0,3,260
2018-03-31,WA,Adams,5,4,9,12470
2018-05-31,WA,Kitsap,1,0,1,53093
2021-01-31,WA,Island,0,0,0,21409
2017-04-30,WA,Pend Oreille,0,0,0,5586
2022-04-30,WA,Klickitat,100,55,155,15247
2018-03-31,WA,Spokane,304,273,577,301278
2021-11-30,WA,Garfield,0,3,3,1350
2017-06-30,WA,Lincoln,2,5,7,7527
2020-07-31,WA,Lincoln,5,11,16,7648
2021-12-31,WA,Kitsap,2129,958,3087,180142
2018-01-31,WA,Island,159,167,326,61838
2017-08-31,WA,Klickitat,21,24,45,14782
2020-06-30,WA,Skamania,31,18,49,8481
2023-05-31,CA,Riverside,6,1,7,348
2017-05-31,WA,Clallam,0,0,0,20959
2017-09-30,WA,Asotin,0,0,0,6507
2021-03-31,WA,Garfield,0,2,2,1365
2022-06-30,CA,Ventura,1,1,2,226
2020-09-30,WA,Franklin,68,76,144,60928
2019-08-31,WA,Clark,1647,959,2606,315547
2018-07-31,WA,Douglas,0,0,0,11970
2019-09-30,WA,Spokane,596,445,1041,313551
2021-05-31,WA,Chelan,0,0,0,23102
2017-07-31,WA,King,8,1,9,187250
2022-02-28,WA,Mason,280,166,446,47722
2019-12-31,WA,Skamania,26,19,45,8767
2022-08-31,WA,Kitsap,19,0,19,53291
2021-05-31,WA,Grays Harbor,161,139,300,49369
2021-03-31,WA,Adams,10,7,17,12997
2020-06-30,WA,Walla Walla,73,62,135,35832
2020-02-29,WA,Clallam,206,163,369,50804
2020-03-31,WA,Jefferson,0,0,0,9594
2020-08-31,WA,Walla Walla,81,65,146,35891
2023-02-28,CA,San Bernardino,2,1,3,272
2018-08-31,CA,San Francisco,1,1,2,121
2019-05-31,WA,Clallam,167,137,304,50565
2023-06-30,WA,King,723,2,725,173265
2021-06-30,WA,Clallam,1,0,1,22026
2020-04-30,WA,Lincoln,4,12,16,7676
2019-06-30,WA,Franklin,0,0,0,19271
2021-02-28,WA,King,28230,8448,36678,1364916
2019-07-31,WA,Whitman,0,0,0,8629
2018-06-30,CA,Ventura,0,2,2,321
2022-11-30,WA,Klickitat,120,53,173,15133
2019-11-30,WA,Yakima,117,116,233,166000
2022-04-30,CA,Kings,2,1,3,304
2018-10-31,WA,San Juan,0,0,0,5787
2017-02-28,WA,Adams,2,2,4,12126
2020-04-30,WA,Klickitat,53,41,94,15425
2020-11-30,WA,Ferry,0,0,0,3598
2019-10-31,CA,Los Angeles,9,8,17,1071
2017-06-30,WA,Clark,787,504,1291,299553
2017-11-30,WA,Stevens,0,0,0,18334
2017-01-31,CA,Marin,1,0,1,57
2021-08-31,WA,Mason,0,0,0,21324
2022-03-31,CA,San Joaquin,1,1,2,88
2020-05-31,WA,Klickitat,53,40,93,15273
2020-09-30,WA,Stevens,0,0,0,18704
2022-04-30,CA,Contra Costa,0,3,3,255
2023-06-30,CA,Orange,6,2,8,249
2022-10-31,WA,Clallam,7,0,7,21890
2018-11-30,WA,Pacific,0,0,0,7611
2020-01-31,WA,Asotin,0,0,0,6720
2017-04-30,WA,Benton,0,0,0,39892
2022-06-30,WA,Pacific,61,71,132,15895
2018-05-31,WA,Adams,5,5,10,12597
2017-08-31,CA,San Diego,6,1,7,2660
2021-07-31,WA,Spokane,1119,653,1772,326073
2017-02-28,WA,Kitsap,1,0,1,52347
2018-09-30,WA,Pierce,0,0,0,138460
2022-11-30,WA,Skagit,8,0,8,32208
2017-03-31,WA,Mason,50,65,115,42929
2022-06-30,WA,Thurston,7,0,7,55513
2020-04-30,WA,Whatcom,3,0,3,42832
2022-08-31,WA,Mason,4,0,4,20986
2022-02-28,WA,Grays Harbor,202,157,359,49318
2020-07-31,WA,Douglas,75,41,116,28050
2021-04-30,WA,Ferry,0,0,0,3649
2018-03-31,CA,Ventura,0,1,1,327
2017-10-31,WA,Grant,0,0,0,25459
2021-07-31,WA,Pend Oreille,15,7,22,9264
2022-09-30,WA,Ferry,22,4,26,4400
2022-10-31,CA,Riverside,7,0,7,417
2017-01-31,WA,Wahkiakum,0,1,1,2861
2018-03-31,WA,Whitman,0,0,0,8453
2022-03-31,WA,Spokane,1443,799,2242,325888
2019-06-30,WA,Grant,41,61,102,64706
2018-11-30,WA,Asotin,12,9,21,12726
2022-04-30,WA,Adams,16,10,26,12985
2018-08-31,WA,Grays Harbor,0,0,0,20309
2017-11-30,WA,Kitsap,1,0,1,52629
2017-04-30,WA,Pend Oreille,1,4,5,9320
2023-04-30,WA,Garfield,1,3,4,1316
2023-05-31,WA,Grant,10,0,10,27771
2022-02-28,WA,Ferry,0,0,0,3567
2017-04-30,WA,Cowlitz,52,48,100,69320
2018-01-31,WA,Columbia,2,1,3,2401
2020-11-30,WA,Wahkiakum,6,6,12,3039
2022-04-30,WA,Snohomish,4,0,4,124628
2020-07-31,WA,Spokane,1,0,1,98982
2022-10-31,WA,Kitsap,25,0,25,53166
2023-04-30,WA,Okanogan,119,58,177,25969
2019-04-30,WA,Columbia,0,0,0,1531
2022-05-31,WA,Clark,3936,1735,5671,316813
2021-08-31,WA,Benton,567,409,976,136208
2017-04-30,WA,Kittitas,21,17,38,27202
2021-06-30,WA,Garfield,0,3,3,1375
2019-05-31,WA,Whitman,0,0,0,8549
2023-06-30,WA,Asotin,35,22,57,12311
2022-02-28,WA,Columbia,0,0,0,1571
2022-11-30,WA,Mason,360,190,550,46961
2023-06-30,WA,Klickitat,151,63,214,14939
2018-04-30,WA,Grant,0,0,0,25855
2018-01-31,WA,San Juan,0,0,0,5644
2021-10-31,WA,Okanogan,0,0,0,16678
2023-03-31,WA,King,51947,13141,65088,1321285
2020-07-31,WA,Grant,61,75,136,65284
2022-03-31,WA,Grant,151,100,251,66866
2021-08-31,WA,Okanogan,0,0,0,16752
2019-07-31,WA,Whatcom,883,436,1319,151115
2019-07-31,WA,Kitsap,1093,625,1718,181246
2022-04-30,WA,Pacific,60,68,128,15938
2019-05-31,WA,Douglas,0,0,0,12182
2022-12-31,WA,Chelan,13,0,13,23093
2018-06-30,WA,Thurston,572,481,1053,193030
2018-09-30,WA,Adams,5,5,10,12682
2019-07-31,WA,King,19627,7112,26739,1391293
2022-04-30,WA,Jefferson,0,0,0,9522
2020-10-31,WA,Lewis,114,115,229,58451
2018-02-28,CA,San Diego,6,1,7,2566
2019-01-31,CA,Riverside,2,2,4,669
2020-05-31,WA,Pacific,31,33,64,15703
2022-07-31,WA,Snohomish,8662,2565,11227,531561
2018-12-31,WA,Whitman,24,38,62,22811
2021-09-30,WA,Klickitat,83,51,134,15391
2022-08-31,WA,Clallam,435,247,682,49540
2017-09-30,CA,Orange,3,1,4,607
2022-02-28,CA,Fresno,1,0,1,152
2022-03-31,WA,Lincoln,0,0,0,4834
2020-05-31,WA,Walla Walla,0,0,0,13670
2017-01-31,WA,Snohomish,1549,803,2352,514965
2023-01-31,WA,Jefferson,495,236,731,24276
2017-03-31,WA,Kitsap,1,0,1,52317
2019-11-30,WA,Klickitat,0,0,0,8306
2020-06-30,WA,Chelan,0,0,0,22520
2019-10-31,WA,Chelan,0,0,0,22495
2022-06-30,WA,Snohomish,12,0,12,123913
2020-08-31,WA,Wahkiakum,0,0,0,1745
2022-01-31,WA,Whitman,69,58,127,21971
2018-04-30,WA,Chelan,0,0,0,21764
2020-05-31,CA,Los Angeles,7,11,18,991
2019-03-31,WA,Ferry,0,0,0,3594
2021-01-31,WA,Columbia,0,0,0,1547
2019-07-31,WA,Pacific,0,0,0,7669
2021-10-31,CA,San Mateo,2,0,2,83
2017-01-31,WA,Wahkiakum,0,0,0,1624
2017-12-31,WA,Skagit,1,0,1,31731
2019-03-31,WA,Franklin,0,0,0,19136
2018-02-28,WA,Klickitat,0,0,0,8038
2017-04-30,WA,Snohomish,1,0,1,122009
2023-06-30,WA,Cowlitz,470,215,685,68949
2023-05-31,CA,Sacramento,4,0,4,129
2018-12-31,WA,Stevens,16,27,43,31786
2017-06-30,CA,San Mateo,0,1,1,151
2018-08-31,CA,Santa Clara,8,0,8,376
2019-03-31,WA,Mason,114,117,231,46714
2021-07-31,WA,Franklin,134,97,231,62058
2020-05-31,WA,Ferry,5,3,8,4331
2019-10-31,CA,San Joaquin,1,0,1,137
2018-08-31,WA,Spokane,1,0,1,93029
2021-08-31,WA,Pacific,48,54,102,16069
2017-07-31,WA,Cowlitz,52,61,113,69775
2021-03-31,WA,Klickitat,65,46,111,15028
2021-09-30,WA,San Juan,462,143,605,14187
2021-09-30,WA,Klickitat,0,0,0,8341
2021-07-31,WA,Walla Walla,115,76,191,36567
2019-12-31,WA,Franklin,0,0,0,19779
2018-09-30,WA,Kittitas,55,36,91,29200
2020-04-30,WA,San Juan,295,88,383,14157
2021-02-28,WA,Lewis,127,132,259,58860
2021-06-30,CA,Santa Cruz,1,0,1,25
2022-05-31,WA,Benton,729,455,1184,135276
2018-11-30,WA,Pierce,1470,1339,2809,538424
2022-11-30,WA,Chelan,525,142,667,54281
2021-01-31,WA,Spokane,0,0,0,100880
2020-02-29,WA,Kittitas,0,0,0,14649
2017-03-31,WA,Lewis,0,0,0,24813
2018-12-31,WA,Wahkiakum,0,0,0,1722
2023-05-31,WA,Lincoln,0,0,0,4844
2023-05-31,WA,Klickitat,145,63,208,15072
2017-02-28,WA,Asotin,4,3,7,12324
2019-02-28,WA,Chelan,0,0,0,22097
2019-07-31,WA,Chelan,161,68,229,54431
2023-04-30,WA,Benton,19,0,19,43089
2022-12-31,CA,Sonoma,1,1,2,61
2022-12-31,WA,Kitsap,34,0,34,52973
2017-06-30,WA,Clallam,90,76,166,48373
2019-08-31,CA,Tuolumne,0,1,1,11
2017-08-31,WA,Whitman,11,22,33,22128
2020-10-31,WA,Pierce,2660,1740,4400,554816
2020-06-30,WA,Okanogan,36,33,69,25848
2019-02-28,WA,Grays Harbor,66,79,145,47455
2017-02-28,WA,San Juan,0,0,0,5573
2022-04-30,CA,Monterey,1,1,2,127
2020-07-31,WA,Thurston,1175,744,1919,197158
2020-10-31,WA,Asotin,17,14,31,12401
2022-03-31,WA,Okanogan,0,0,0,16693
2023-07-31,WA,Skagit,23,0,23,30998
2019-07-31,CA,San Joaquin,1,0,1,128
2020-11-30,WA,King,26599,8083,34682,1371168
2019-09-30,WA,Jefferson,207,126,333,25125
2023-01-31,WA,Wahkiakum,25,15,40,3050
2017-05-31,WA,Garfield,0,0,0,932
2017-07-31,CA,Marin,1,0,1,58
2018-07-31,WA,Okanogan,9,20,29,26029
2020-03-31,WA,King,5,1,6,182420
2020-03-31,CA,Los Angeles,7,11,18,1027
2017-05-31,CA,Orange,3,1,4,644
2020-01-31,CA,San Francisco,2,1,3,101
2017-03-31,WA,Spokane,1,0,1,90256
2019-12-31,WA,Grays Harbor,0,0,0,20770
2022-02-28,WA,Douglas,122,55,177,28558
2021-03-31,WA,Asotin,17,14,31,12569
2020-10-31,WA,Whitman,0,0,0,8487
2019-07-31,CA,Tuolumne,0,1,1,12
2020-11-30,WA,Chelan,271,84,355,54377
2021-02-28,WA,Grant,0,0,0,27662
2020-10-31,WA,Snohomish,4831,1816,6647,537854
2017-03-31,WA,Skamania,0,0,0,3882
2020-10-31,WA,Adams,0,0,0,5335
2018-01-31,WA,Franklin,0,0,0,18563
2021-02-28,WA,Ferry,10,3,13,4332
2020-02-29,WA,Skamania,28,19,47,8773
2020-11-30,WA,Douglas,0,0,0,12451
2021-05-31,WA,Whatcom,4,0,4,43874
2021-09-30,WA,Clallam,1,0,1,22018
2022-04-30,WA,Garfield,0,3,3,1332
2021-03-31,WA,Grays Harbor,0,0,0,21269
2020-12-31,WA,Spokane,886,547,1433,321109
2017-10-31,WA,Cowlitz,0,0,0,28114
2023-05-31,WA,Benton,22,0,22,42823
2021-04-30,WA,Snohomish,5588,1967,7555,540438
2021-06-30,WA,Island,0,0,0,21624
2019-11-30,WA,Mason,0,0,0,20508
2018-04-30,CA,Contra Costa,0,1,1,461
2022-06-30,WA,Jefferson,2,0,2,9461
2023-01-31,WA,Skamania,1,0,1,3877
2018-04-30,WA,Clark,0,0,0,78735
2021-05-31,WA,Stevens,0,0,0,18957
2022-04-30,WA,San Juan,1,0,1,5986
2021-12-31,WA,Chelan,408,114,522,54685
2019-11-30,CA,Santa Clara,6,2,8,360
2023-05-31,WA,Island,1044,430,1474,60998
2022-05-31,WA,Whatcom,5,0,5,43377
2019-12-31,WA,Chelan,0,0,0,22549
2017-09-30,WA,Stevens,0,0,0,18251
2019-06-30,WA,Snohomish,0,0,0,122375
2019-03-31,WA,Cowlitz,0,0,0,28781
2018-07-31,WA,Whitman,19,28,47,22658
2018-03-31,CA,Tuolumne,0,1,1,14
2020-10-31,WA,Island,1,0,1,21311
2020-09-30,WA,Okanogan,0,0,0,16547
2018-03-31,WA,Clallam,119,104,223,49504
2023-07-31,CA,Sonoma,1,1,2,43
2018-03-31,WA,Thurston,0,0,0,54007
2021-08-31,WA,Benton,0,0,0,43605
2019-03-31,CA,Ventura,0,2,2,311
2019-08-31,CA,Placer,1,0,1,98
2022-03-31,WA,Pierce,2,0,2,143506
2022-02-28,WA,Franklin,175,102,277,62074
2023-03-31,CA,Kings,2,1,3,268
2018-08-31,WA,Walla Walla,34,48,82,35872
2019-10-31,WA,Lincoln,0,0,0,4691
2017-02-28,WA,Mason,47,63,110,42778
2018-11-30,CA,Fresno,1,0,1,189
2022-01-31,WA,Klickitat,0,0,0,8335
2023-01-31,CA,Sonoma,1,1,2,60
2020-06-30,CA,Placer,2,0,2,89
2019-09-30,WA,Grant,48,63,111,65170
2022-09-30,WA,Mason,339,178,517,46951
2018-02-28,WA,Kittitas,36,27,63,28690
2022-07-31,CA,Solano,1,0,1,154
2018-04-30,WA,Jefferson,134,88,222,24353
2019-07-31,CA,Santa Clara,4,2,6,365
2017-11-30,WA,Franklin,0,0,0,18414
2022-03-31,WA,Kitsap,1,0,1,53996
2022-08-31,WA,Benton,5,0,5,43422
2019-07-31,WA,Whitman,33,45,78,22702
2017-02-28,WA,Kitsap,561,280,841,172111
2019-06-30,WA,Douglas,57,37,94,28032
2021-12-31,WA,Skagit,1,0,1,32702
2017-02-28,WA,Chelan,0,0,0,21250
2017-11-30,WA,Skamania,0,0,0,3893
2018-12-31,WA,Whitman,0,0,0,8542
2021-01-31,WA,King,27793,8324,36117,1367229
2018-06-30,WA,Whatcom,2,0,2,42285
2022-09-30,CA,Marin,0,1,1,27
2018-03-31,WA,Wahkiakum,0,0,0,1668
2020-09-30,WA,Columbia,0,0,0,1532
2019-09-30,WA,Douglas,62,37,99,28207
2023-01-31,WA,Benton,13,0,13,43322
2021-07-31,WA,Jefferson,339,183,522,24889
2023-03-31,WA,Whitman,4,0,4,8597
2022-12-31,CA,Santa Clara,9,2,11,170
2017-02-28,WA,Wahkiakum,0,0,0,1625
2018-10-31,WA,King,7,1,8,182837
2023-03-31,CA,Solano,4,0,4,134
2023-03-31,WA,Walla Walla,5,0,5,13756
2017-11-30,WA,Grant,0,0,0,25520
2018-10-31,WA,Ferry,3,2,5,4406
2018-09-30,CA,San Mateo,1,1,2,132
2018-05-31,WA,Lewis,0,0,0,25406
2020-09-30,WA,Kitsap,1426,713,2139,179647
2023-03-31,WA,Douglas,6,0,6,12871
